"";"RSAL";"RGALLER";"REARING_NUMBER";"LEG";"N_GALLS";"N_CLEAN GALLS";"N_REAL GALLS";"PARASITISED_GALLS";"UNPARASITISED_GALLS";"TOTAL_PARASITISM RATE"
"12";"Sal1";"Oelaea";"198714E1-J1Oelaea";"20.07.87";22;0;22;20;2;0,909090909
"13";"Sal2";"Obridg";"198714L1-V1Obridg";"20.07.87";32;7;25;15;10;0,6
"14";"Sal3";"Ovaria";"198715A1-V1Ovaria";"22.07.87";66;0;66;30;36;0,454545455
"15";"Sal4";"Oobscu";"198715A-VOobscu";"20.07.87";66;14;52;34;18;0,653846154
"16";"Sal1";"Okriec";"198714A-C1Okriec";"20.07.87";91;0;91;78;13;0,857142857
"17";"Sal3";"Onigri";"198716A-C1Onigri";"22.07.87";92;8;84;27;57;0,321428571
"18";"Sal3";"Ovaria";"198716E1-V1Ovaria";"22.07.87";54;8;46;24;22;0,52173913
"19";"Sal4";"Ofoeti";"198717A-P1Ofoeti";"22.07.87";125;0;125;8;117;0,064
"20";"Sal4";"Oobscu";"198718A-Q1Oobscu";"22.07.87";129;12;117;1;116;0,008547009
"21";"Sal3";"Onigri";"198719A-DOnigri";"22.07.87";14;5;9;1;8;0,111111111
"22";"Sal3";"Ovaria";"198719F-JOvaria";"22.07.87";14;0;14;1;13;0,071428571
"23";"Sal5";"Ohasta";"198719I1-L1Ohasta";"22.07.87";12;0;12;0;12;0
"24";"Sal4";"Ofoeti";"198719T-G1Ofoeti";"22.07.87";42;0;42;1;41;0,023809524
"25";"Sal6";"Oadaph";"198720A-D1Oadaph";"22.07.87";90;0;90;7;83;0,077777778
"26";"Sal3";"Ovaria";"198720E1-V1Ovaria";"22.07.87";72;0;72;9;63;0,125
"27";"Sal7";"Ohelve";"198721A-V1Ohelve";"23.07.87";150;8;142;110;32;0,774647887
"28";"Sal8";"Onival";"198722A-V1Onival";"23.07.87";151;0;151;29;122;0,19205298
"29";"Sal9";"Obridg";"198634H1-M1Obridg";"17.07.86";24;0;24;22;2;0,916666667
"30";"Sal10";"Ovimin";"198636E1-37V1Ovimin";"17.07.86";276;0;276;57;219;0,206521739
"31";"Sal11";"Oproxi";"198638A-J1Oproxi";"18.07.86";142;24;118;102;16;0,86440678
"32";"Sal12";"Oproxi";"198639A-O1Oproxi";"18.07.86";212;6;206;193;13;0,936893204
"33";"Sal13";"Ocolla";"198640A-41V1Ocolla";"20.07.86";384;0;384;148;236;0,385416667
"34";"Sal13";"Ocolla";"198642A-43V1Ocolla";"20.07.86";307;0;307;80;227;0,260586319
"35";"Sal12";"Oproxi";"198645A-V1Oproxi";"22.07.86";170;12;158;149;9;0,943037975
"36";"Sal11";"Oproxi";"198646A-47V1Oproxi";"22.07.86";355;0;355;351;4;0,988732394
"37";"Sal6";"Oadaph";"198648A-JOadaph";"26.07.86";30;0;30;2;28;0,066666667
"38";"Sal11";"Oproxi";"198648M-B1Oproxi";"25.07.86";51;2;49;31;18;0,632653061
"39";"Sal12";"Oproxi";"198649A-H1Oproxi";"26.07.86";102;5;97;93;4;0,958762887
"40";"Sal14";"Osamol";"199045A-ROsamol";"08.08.90";72;6;66;13;53;0,196969697
"41";"Sal15";"Omyrsi";"199045T-48QOmyrsi";"08.08.90";568;43;525;174;351;0,331428571
"42";"Sal16";"Oarcti";"199048S-49D1Oarcti";"08.08.90";240;15;225;54;171;0,24
"43";"Sal17";"Onival";"199049F1-N1Onival";"08.08.90";38;5;33;23;10;0,696969697
"44";"Sal17";"Eboreo";"199050A-51WEboreo";"10.08.90";424;43;381;4;377;0,010498688
"45";"Sal17";"Onival";"199051Y-V1Onival";"10.08.90";116;32;84;16;68;0,19047619
"46";"Sal17";"Oglauc";"199052A-NOglauc";"10.08.90";56;15;41;14;27;0,341463415
"47";"Sal14";"Elappo";"199052I1-Q1Elappo";"10.08.90";54;5;49;0;49;0
"48";"Sal14";"Elappc";"199052P-G1Elappc";"10.08.90";108;2;106;0;106;0
"49";"Sal14";"Osamol";"199052S1-V1Osamol";"10.08.90";13;1;12;0;12;0
"50";"Sal14";"Olappo";"199053A-MOlappo";"10.08.90";53;6;47;8;39;0,170212766
"51";"Sal14";"Olappl";"199053O-WOlappl";"10.08.90";38;9;29;6;23;0,206896552
"52";"Sal3";"Onigri";"199054A-QOnigri";"15.08.90";68;23;45;37;8;0,822222222
"53";"Sal3";"Emyrsi";"199054S-55HEmyrsi";"15.08.90";228;45;183;82;101;0,448087432
"54";"Sal3";"Ovaria";"199055J-V1Ovaria";"15.08.90";194;37;157;89;68;0,566878981
"55";"Sal18";"Ogalla";"199101A1-3GOgalla";"06.08.91";306;45;261;88;173;0,337164751
"56";"Sal18";"Ogalla";"199101G-SOgalla";"31.07.91";50;0;50;7;43;0,14
"57";"Sal19";"Hischn";"199104A-V1Hischn";"27.08.91";122;19;103;16;87;0,155339806
"58";"Sal19";"Emyrsi";"199105A-WEmyrsi";"27.08.91";137;24;113;4;109;0,03539823
"59";"Sal19";"Onigri";"199105Y-O1Onigri";"27.08.91";68;16;52;45;7;0,865384615
"60";"Sal19";"Ovaria";"199106A-J1Ovaria";"27.08.91";144;2;142;51;91;0,35915493
"61";"Sal5";"Ehasta";"199106L1-V1Ehasta";"27.08.91";57;22;35;1;34;0,028571429
"62";"Sal20";"Egemmf";"199107A-8IEgemmf";"27.08.91";344;74;270;22;248;0,081481481
"63";"Sal20";"Ofoeti";"199108K-9EOfoeti";"27.08.91";172;1;171;31;140;0,18128655
"64";"Sal20";"Omonti";"199109G-NOmonti";"27.08.91";33;0;33;1;32;0,03030303
"65";"Sal20";"Oobscu";"199109P-ROobscu";"27.08.91";12;0;12;6;6;0,5
"66";"Sal4";"Ofoeti";"199109T-V1Ofoeti";"29.08.91";127;0;127;10;117;0,078740157
"67";"Sal4";"Omonti";"199110A-11QOmonti";"29.08.91";260;1;259;31;228;0,11969112
"68";"Sal4";"Oobscu";"199111H1-V1Oobscu";"29.08.91";96;11;85;33;52;0,388235294
"69";"Sal4";"Egemmf";"199111S-F1Egemmf";"29.08.91";88;19;69;0;69;0
"70";"Sal1";"Okriec";"199112A-E1Okriec";"30.08.91";124;12;112;47;65;0,419642857
"71";"Sal1";"Eelaea";"199112F1-13MEelaea";"30.08.91";116;8;108;45;63;0,416666667
"72";"Sal1";"Eelaea";"199113O-T1Eelaea";"30.08.91";125;16;109;88;21;0,80733945
"73";"Sal1";"Eelaea";"199114A-FEelaea";"30.08.91";24;0;24;2;22;0,083333333
"74";"Sal1";"Okriec";"199114H-15VOkriec";"31.08.91";248;38;210;97;113;0,461904762
"75";"Sal21";"Hcarin";"199115X-16WHcarin";"01.09.91";192;66;126;67;59;0,531746032
"76";"Sal5";"Ehasta";"199116Q1-T1Ehasta";"01.09.91";24;9;15;2;13;0,133333333
"77";"Sal5";"Ohasta";"199116Y-O1Ohasta";"01.09.91";68;0;68;10;58;0,147058824
"78";"Sal8";"Onival";"199117A-C1Onival";"01.09.91";116;6;110;18;92;0,163636364
"79";"Sal8";"Eboreo";"199117E1-G1Eboreo";"01.09.91";17;2;15;1;14;0,066666667
"80";"Sal7";"Egemmh";"199117I1-K1Egemmh";"01.09.91";20;5;15;2;13;0,133333333
"81";"Sal8";"Hplicg";"199117M1-V1Hplicg";"02.09.91";38;3;35;27;8;0,771428571
"82";"Sal7";"Omacul";"199118A1-Q1Omacul";"01.09.91";74;1;73;33;40;0,452054795
"83";"Sal5";"Ehasta";"199118A-ZEhasta";"02.09.91";164;36;128;41;87;0,3203125
"84";"Sal7";"Egemmh";"199118R1-U1Egemmh";"01.09.91";36;18;18;4;14;0,222222222
"85";"Sal7";"Egemmh";"199119A-O1Egemmh";"04.09.91";247;25;222;101;121;0,454954955
"86";"Sal7";"Hspirh";"199119Q1-20XHspirh";"04.09.91";107;55;52;11;41;0,211538462
"87";"Sal7";"Omacul";"199120A1-G1Omacul";"04.09.91";28;0;28;14;14;0,5
"88";"Sal5";"Ehasta";"199120I1-J1Ehasta";"04.09.91";12;6;6;1;5;0,166666667
"89";"Sal5";"Ohasta";"199120L1-M1Ohasta";"04.09.91";8;0;8;0;8;0
"90";"Sal8";"Onival";"199121A-UOnival";"04.09.91";83;1;82;16;66;0,195121951
"91";"Sal8";"Hplicg";"199121W-V1Hplicg";"04.09.91";76;24;52;47;5;0,903846154
"92";"Sal5";"Ehasta";"199122A1-O1Ehasta";"05.09.91";91;7;84;3;81;0,035714286
"93";"Sal7";"Omacul";"199122F-ROmacul";"04.09.91";53;1;52;11;41;0,211538462
"94";"Sal7";"Egemmh";"199122T-UEgemmh";"04.09.91";14;6;8;0;8;0
"95";"Sal22";"Obrevi";"199123A-24HObrevi";"05.09.91";226;0;226;137;89;0,60619469
"96";"Sal7";"Egemmh";"199124A1-D1Egemmh";"06.09.91";23;2;21;16;5;0,761904762
"97";"Sal4";"Oobscu";"199124E1-T1Oobscu";"06.09.91";100;35;65;54;11;0,830769231
"98";"Sal23";"Oretic";"199124J-MOretic";"05.09.91";19;0;19;9;10;0,473684211
"99";"Sal24";"Oretus";"199124O-XOretus";"05.09.91";40;0;40;33;7;0,825
"100";"Sal4";"Egemmf";"199124U1-V1Egemmf";"06.09.91";14;6;8;7;1;0,875
"101";"Sal18";"Enigri";"199125A-K1Enigri";"22.09.91";222;9;213;123;90;0,577464789
"102";"Sal25";"Emucro";"199125M1-T1Emucro";"23.09.91";48;3;45;1;44;0,022222222
"103";"Sal25";"Emucro";"199126A-27UEmucro";"23.10.91";414;0;414;60;354;0,144927536
"104";"Sal25";"Emucro";"199127W-28KEmucro";"23.10.91";222;0;222;6;216;0,027027027
"105";"Sal19";"Onigri";"199201A-2V1Onigri";"19.07.92";411;33;378;22;356;0,058201058
"106";"Sal20";"Ofoeti";"199203A-B1Ofoeti";"19.07.92";112;1;111;26;85;0,234234234
"107";"Sal19";"Emyrsi";"199204A-TEmyrsi";"25.08.92";96;40;56;2;54;0,035714286
"108";"Sal19";"Onigri";"199204K1-5OOnigri";"25.08.92";107;16;91;33;58;0,362637363
"109";"Sal19";"Ovaria";"199204V-I1Ovaria";"25.08.92";57;2;55;8;47;0,145454545
"110";"Sal20";"Egemmf";"199205Q-V1Egemmf";"25.08.92";160;43;117;2;115;0,017094017
"111";"Sal20";"Egemmf";"199206A-UEgemmf";"25.08.92";105;41;64;2;62;0,03125
"112";"Sal20";"Omonti";"199206J1-K1Omonti";"25.08.92";8;0;8;0;8;0
"113";"Sal5";"Ehasta";"199206M1-7FEhasta";"25.08.92";81;29;52;4;48;0,076923077
"114";"Sal20";"Ofoeti";"199206W-H1Ofoeti";"25.08.92";46;4;42;17;25;0,404761905
"115";"Sal19";"Emyrsi";"199207H1-8G1Emyrsi";"25.08.92";276;69;207;36;171;0,173913043
"116";"Sal19";"Ovaria";"199207H-F1Ovaria";"25.08.92";128;3;125;25;100;0,2
"117";"Sal19";"Emyrsi";"199208I1-V1Emyrsi";"25.08.92";80;22;58;6;52;0,103448276
"118";"Sal19";"Ovaria";"199209A-M1Ovaria";"25.08.92";155;6;149;20;129;0,134228188
"119";"Sal1";"Eelaea";"199210A-QEelaea";"25.08.92";69;7;62;0;62;0
"120";"Sal1";"Eelaea";"199210S-11K1Eelaea";"26.08.92";268;55;213;78;135;0,366197183
"121";"Sal21";"Hcarin";"199211O1-V1Hcarin";"27.08.92";227;49;178;40;138;0,224719101
"122";"Sal7";"Egemmh";"199212A-V1Egemmh";"27.08.92";248;67;181;12;169;0,066298343
"123";"Sal5";"Ehasta";"199213A-UEhasta";"28.08.92";107;38;69;0;69;0
"124";"Sal5";"Ohasta";"198723A-V1Ohasta";"23.07.87";144;4;140;35;105;0,25
"125";"Sal7";"Omacul";"198724A-R1Omacul";"23.07.87";129;0;129;12;117;0,093023256
"126";"Sal7";"Ohelve";"198724S1-V1Ohelve";"23.07.87";21;0;21;0;21;0
"127";"Sal22";"Obrevi";"198725A-26V1Obrevi";"26.07.87";288;1;287;9;278;0,031358885
"128";"Sal5";"Ohasta";"198727A-V1Ohasta";"26.07.87";144;1;143;70;73;0,48951049
"129";"Sal8";"Onival";"198728A-C1Onival";"27.07.87";88;6;82;3;79;0,036585366
"130";"Sal6";"Oadaph";"198728E1-R1Oadaph";"27.07.87";41;1;40;3;37;0,075
"131";"Sal7";"Omacul";"198729A-30E1Omacul";"27.07.87";237;4;233;33;200;0,141630901
"132";"Sal7";"Ohelve";"198730G1-31V1Ohelve";"27.07.87";202;9;193;116;77;0,601036269
"133";"Sal10";"Ovesic";"198732A-H1Ovesic";"27.07.87";102;0;102;1;101;0,009803922
"134";"Sal10";"Ovimin";"198732J1-S1Ovimin";"27.07.87";30;0;30;0;30;0
"135";"Sal5";"Ohasta";"198733A1-F1Ohasta";"27.07.87";19;0;19;1;18;0,052631579
"136";"Sal10";"Oviril";"198733A-YOviril";"27.07.87";75;0;75;22;53;0,293333333
"137";"Sal2";"Obridg";"198733K1-V1Obridg";"27.07.87";35;1;34;11;23;0,323529412
"138";"Sal3";"Ovaria";"198734A-35V1Ovaria";"28.07.87";288;4;284;90;194;0,316901408
"139";"Sal5";"Ohasta";"198736A-37ROhasta";"30.07.87";197;3;194;17;177;0,087628866
"140";"Sal6";"Oadaph";"198737T-38H1Oadaph";"30.07.87";189;2;187;106;81;0,56684492
"141";"Sal6";"Oadaph";"198738K1-T1Oadaph";"30.07.87";15;4;11;3;8;0,272727273
"142";"Sal18";"Obridg";"198743D-KObridg";"14.07.87";10;0;10;7;3;0,7
"143";"Sal9";"Opedun";"198743U-V1Opedun";"14.07.87";36;0;36;28;8;0,777777778
"144";"Sal9";"Obridg";"198744A-KObridg";"14.07.87";15;0;15;8;7;0,533333333
"145";"Sal18";"Ogalla";"198744M-XOgalla";"14.07.87";32;0;32;8;24;0,25
"146";"Sal11";"Oproxi";"198745A-E1Oproxi";"02.10.87";94;11;83;31;52;0,373493976
"147";"Sal10";"Ovimin";"198746A-47LOvimin";"02.10.87";183;0;183;78;105;0,426229508
"148";"Sal26";"Otrian";"198747M-48FOtrian";"17.10.87";123;0;123;14;109;0,113821138
"149";"Sal12";"Oproxi";"198748H-K1Oproxi";"22.10.87";88;0;88;17;71;0,193181818
"150";"Sal10";"Ovimin";"198748M1-49WOvimin";"17.10.87";100;0;100;88;12;0,88
"151";"Sal10";"Oviril";"1987SAOviril";"26.05.87";105;5;100;4;96;0,04
"152";"Sal27";"Oglabr";"198801A1-2V1Oglabr";"27.07.88";204;6;198;3;195;0,015151515
"153";"Sal16";"Oarcti";"198801A-ZOarcti";"26.07.88";78;4;74;6;68;0,081081081
"154";"Sal17";"Onival";"198803A-4JOnival";"27.07.88";175;6;169;19;150;0,112426036
"155";"Sal5";"Ohasta";"198804L-Q1Ohasta";"27.07.88";97;4;93;13;80;0,139784946
"156";"Sal14";"Olappo";"198805A-6V1Olappo";"27.07.88";288;6;282;12;270;0,042553191
"157";"Sal16";"Oarcti";"198807A-V1Oarcti";"27.07.88";144;7;137;6;131;0,04379562
"158";"Sal17";"Onival";"198808A-V1Onival";"27.07.88";131;6;125;47;78;0,376
"159";"Sal14";"Olappo";"198809A-V1Olappo";"27.07.88";125;0;125;54;71;0,432
"160";"Sal14";"Olappl";"198809V1Olappl";"27.07.88";2;0;2;2;0;1
"161";"Sal17";"Onival";"198810A-F1Onival";"27.07.88";97;4;93;32;61;0,344086022
"162";"Sal17";"Oglauc";"198810H1-V1Oglauc";"27.07.88";28;0;28;26;2;0,928571429
"163";"Sal16";"Opustu";"198811A-12G1Opustu";"29.07.88";163;12;151;31;120;0,205298013
"164";"Sal3";"Ovaria";"198812I1-13V1Ovaria";"29.07.88";191;3;188;62;126;0,329787234
"165";"Sal23";"Oretic";"198814A-KOretic";"30.07.88";34;0;34;10;24;0,294117647
"166";"Sal5";"Ohasta";"198814M-V1Ohasta";"30.07.88";127;2;125;35;90;0,28
"167";"Sal27";"Oglabr";"198815A-16V1Oglabr";"30.07.88";288;12;276;61;215;0,221014493
"168";"Sal14";"Olappo";"198817A-18V1Olappo";"30.07.88";155;0;155;73;82;0,470967742
"169";"Sal17";"Onival";"198819A-20J1Onival";"30.07.88";258;35;223;56;167;0,251121076
"170";"Sal17";"Oglauc";"198820K1-V1Oglauc";"30.07.88";48;34;14;4;10;0,285714286
"171";"Sal28";"Oherba";"198821A-23V1Oherba";"31.07.88";432;26;406;222;184;0,54679803
"172";"Sal18";"Evenus";"198825O1-V1Evenus";"03.08.88";24;1;23;0;23;0
"173";"Sal16";"Oarcti";"198826A-V1Oarcti";"04.08.88";109;0;109;18;91;0,165137615
"174";"Sal18";"Ogalla";"198827A-QOgalla";"03.08.88";51;0;51;8;43;0,156862745
"175";"Sal17";"Onival";"198827S-28V1Onival";"03.08.88";210;28;182;41;141;0,225274725
"176";"Sal14";"Olappo";"198829A-QOlappo";"05.08.88";51;0;51;25;26;0,490196078
"177";"Sal14";"Olappl";"198829C1-Q1Olappl";"05.08.88";55;29;26;20;6;0,769230769
"178";"Sal14";"Osamol";"198829S-A1Osamol";"05.08.88";27;2;25;7;18;0,28
"179";"Sal5";"Ehasta";"198830A-G1Ehasta";"07.08.88";132;18;114;6;108;0,052631579
"180";"Sal5";"Ohasta";"198830H1-Q1Ohasta";"07.08.88";32;0;32;22;10;0,6875
"181";"Sal27";"Oglabr";"198831A-32V1Oglabr";"09.08.88";283;36;247;62;185;0,251012146
"182";"Sal17";"Onival";"198833A-35XOnival";"09.08.88";359;38;321;127;194;0,395638629
"183";"Sal14";"Osamol";"198835A1-36POsamol";"09.08.88";121;0;121;18;103;0,148760331
"184";"Sal16";"Oarcti";"198836R-37LOarcti";"09.08.88";136;11;125;23;102;0,184
"185";"Sal16";"Oarcti";"198837K1-39V1Oarcti";"11.08.88";324;83;241;26;215;0,107883817
"186";"Sal28";"Oherba";"198837N-I1Oherba";"09.08.88";65;0;65;55;10;0,846153846
"187";"Sal5";"Ohasta";"198840A-41IOhasta";"11.08.88";181;11;170;110;60;0,647058824
"188";"Sal14";"Osamol";"198841A1-44LOsamol";"11.08.88";390;88;302;89;213;0,294701987
"189";"Sal5";"Ehasta";"198841K-ZEhasta";"11.08.88";66;10;56;3;53;0,053571429
"190";"Sal14";"Olappo";"198844M-TOlappo";"11.08.88";24;0;24;13;11;0,541666667
"191";"Sal14";"Elappo";"198844Q1-45KElappo";"11.08.88";68;4;64;3;61;0,046875
"192";"Sal16";"Oarcti";"198844U-VOarcti";"11.08.88";6;0;6;0;6;0
"193";"Sal14";"Osamol";"198844X-O1Osamol";"11.08.88";54;30;24;4;20;0,166666667
"194";"Sal28";"Oherba";"198845M-V1Oherba";"13.08.88";108;8;100;60;40;0,6
"195";"Sal23";"Oretic";"198846A-49POretic";"13.08.88";479;49;430;138;292;0,320930233
"196";"Sal28";"Oherba";"198849R-51V1Oherba";"13.08.88";381;65;316;168;148;0,53164557
"197";"Sal14";"Elappo";"198852A-53V1Elappo";"15.08.88";500;0;500;3;497;0,006
"198";"Sal14";"Elappc";"198854A-DElappc";"15.08.88";15;0;15;0;15;0
"199";"Sal29";"Onorve";"198854F-J1Onorve";"19.08.88";93;0;93;24;69;0,258064516
"200";"Sal16";"Ephyli";"198854L1-N1Ephyli";"19.08.88";11;0;11;0;11;0
"201";"Sal15";"Omyrsi";"198855A-UOmyrsi";"15.08.88";64;2;62;15;47;0,241935484
"202";"Sal14";"Elappc";"198855W-56ZElappc";"15.08.88";208;0;208;3;205;0,014423077
"203";"Sal15";"Ospeit";"198855VOspeit";"15.08.88";2;0;2;2;0;1
"204";"Sal14";"Elappo";"198856A1-V1Elappo";"15.08.88";105;0;105;0;105;0
"205";"Sal15";"Omyrsi";"198857A-B1Omyrsi";"19.08.88";84;0;84;2;82;0,023809524
"206";"Sal15";"Omyrsi";"198857D1-58JOmyrsi";"19.08.88";85;3;82;15;67;0,182926829
"207";"Sal18";"Ogalla";"198858L-59XOgalla";"22.08.88";180;3;177;18;159;0,101694915
"208";"Sal28";"Oherba";"198859A1-60Oherba";"22.08.88";210;5;205;33;172;0,16097561
"209";"Sal14";"Elappc";"198864M-YElappc";"15.08.88";16;0;16;6;10;0,375
"210";"Sal10";"Ovimin";"198876A-77H1Ovimin";"24.06.88";246;0;246;41;205;0,166666667
"211";"Sal10";"Ovesic";"198877J1-R1Ovesic";"24.06.88";17;0;17;3;14;0,176470588
"212";"Sal25";"Obella";"198878A-V1Obella";"22.09.88";16;0;16;7;9;0,4375
"213";"Sal9";"Hpruss";"1988SZS-CHpruss";"13.07.88";144;15;129;6;123;0,046511628
"214";"Sal10";"Ovesic";"198901A-E1Ovesic";"31.05.89";96;0;96;15;81;0,15625
"215";"Sal10";"Ovimin";"198901G1-L1Ovimin";"31.05.89";18;0;18;6;12;0,333333333
"216";"Sal10";"Ovimin";"198902A1-3EOvimin";"31.05.89";91;0;91;23;68;0,252747253
"217";"Sal10";"Ovimin";"198902C-YOvimin";"31.05.89";69;0;69;12;57;0,173913043
"218";"Sal12";"Oproxi";"198903A1-4XOproxi";"01.06.89";139;1;138;58;80;0,420289855
"219";"Sal10";"Oviril";"198903G-TOviril";"31.05.89";43;1;42;29;13;0,69047619
"220";"Sal10";"Ovimin";"198904A1-L1Ovimin";"31.05.89";37;0;37;4;33;0,108108108
"221";"Sal10";"Oviril";"198904N1-R1Oviril";"31.05.89";15;0;15;5;10;0,333333333
"222";"Sal11";"Oproxi";"198905A-V1Oproxi";"31.05.89";117;1;116;73;43;0,629310345
"223";"Sal1";"Oelaea";"198906A-9V1Oelaea";"29.06.89";768;34;734;202;532;0,27520436
"224";"Sal3";"Onigri";"198910A-V1Onigri";"30.06.89";192;19;173;54;119;0,312138728
"225";"Sal3";"Onigri";"198911A-V1Onigri";"30.06.89";195;12;183;38;145;0,207650273
"226";"Sal7";"Ohelve";"198912A-V1Ohelve";"02.07.89";209;9;200;17;183;0,085
"227";"Sal10";"Ovesic";"198913A-14V1Ovesic";"04.07.89";204;25;179;49;130;0,273743017
"228";"Sal3";"Ovaria";"198915A1-16POvaria";"10.08.89";88;3;85;40;45;0,470588235
"229";"Sal2";"Obridg";"198915A-IObridg";"10.08.89";36;7;29;15;14;0,517241379
"230";"Sal2";"Obridg";"198915K-YObridg";"10.08.89";62;3;59;13;46;0,220338983
"231";"Sal10";"Ovimin";"198916R-V1Ovimin";"11.08.89";124;16;108;88;20;0,814814815
"232";"Sal4";"Ofoeti";"198917A-QOfoeti";"11.08.89";67;0;67;19;48;0,28358209
"233";"Sal3";"Ovaria";"198917O1-18WOvaria";"11.08.89";125;4;121;61;60;0,504132231
"234";"Sal1";"Okriec";"198917T-M1Okriec";"11.08.89";80;1;79;18;61;0,227848101
"235";"Sal1";"Okriec";"198918A1-20ZOkriec";"11.08.89";385;1;384;61;323;0,158854167
"236";"Sal19";"Onigri";"198920A1-21V1Onigri";"12.08.89";280;28;252;66;186;0,261904762
"237";"Sal19";"Ovaria";"198922A-23V1Ovaria";"12.08.89";384;21;363;45;318;0,123966942
"238";"Sal20";"Omonti";"198924A-JOmonti";"12.08.89";43;0;43;8;35;0,186046512
"239";"Sal20";"Ofoeti";"198924L-L1Ofoeti";"12.08.89";109;0;109;18;91;0,165137615
"240";"Sal20";"Oobscu";"198924M1-R1Oobscu";"12.08.89";19;8;11;1;10;0,090909091
"241";"Sal20";"Egemmf";"198925A-D1Egemmf";"12.08.89";119;0;119;0;119;0
"242";"Sal3";"Ovaria";"198925E1-26I1Ovaria";"13.08.89";214;15;199;80;119;0,40201005
"243";"Sal4";"Omonti";"198926K1-27EOmonti";"13.08.89";70;1;69;1;68;0,014492754
"244";"Sal3";"Ovaria";"198927A1-28V1Ovaria";"13.08.89";280;15;265;52;213;0,196226415
"245";"Sal4";"Ofoeti";"198927G-TOfoeti";"13.08.89";56;0;56;7;49;0,125
"246";"Sal4";"Oobscu";"198927V-XOobscu";"13.08.89";12;0;12;1;11;0,083333333
"247";"Sal5";"Ohasta";"198929A-V1Ohasta";"15.08.89";184;17;167;64;103;0,383233533
"248";"Sal8";"Onival";"198934A-J1Onival";"15.08.89";146;20;126;16;110;0,126984127
"249";"Sal3";"Ovaria";"198934L1-36KOvaria";"15.08.89";90;7;83;26;57;0,313253012
"250";"Sal8";"Onival";"198936D1-37EOnival";"15.08.89";96;5;91;18;73;0,197802198
"251";"Sal7";"Omacul";"198936M-B1Omacul";"15.08.89";63;1;62;13;49;0,209677419
"252";"Sal3";"Ovaria";"198937G-Q1Ovaria";"16.08.89";148;3;145;7;138;0,048275862
"253";"Sal7";"Omacul";"198937R1-V1Omacul";"17.08.89";25;1;24;8;16;0,333333333
"254";"Sal3";"Ovaria";"198939C-EOvaria";"22.08.89";15;0;15;7;8;0,466666667
"255";"Sal10";"Ovimin";"198939G-SOvimin";"22.08.89";50;0;50;35;15;0,7
"256";"Sal14";"Olappo";"199001A-V1Olappo";"17.07.90";192;13;179;65;114;0,363128492
"257";"Sal14";"Olappo";"199002A-S1Olappo";"18.07.90";180;12;168;32;136;0,19047619
"258";"Sal14";"Olappl";"199002U1-V1Olappl";"18.07.90";12;6;6;4;2;0,666666667
"259";"Sal14";"Olappo";"199003A-UOlappo";"17.07.90";84;9;75;36;39;0,48
"260";"Sal16";"Opustu";"199003I1-V1Opustu";"18.07.90";49;6;43;20;23;0,465116279
"261";"Sal14";"Olappl";"199003W-G1Olappl";"17.07.90";54;19;35;27;8;0,771428571
"262";"Sal3";"Ovaria";"199004A-SOvaria";"20.07.90";76;5;71;19;52;0,267605634
"263";"Sal5";"Ohasta";"199004U-5I1Ohasta";"22.07.90";252;20;232;135;97;0,581896552
"264";"Sal27";"Oglabr";"199005K1-V1Oglabr";"22.07.90";41;5;36;3;33;0,083333333
"265";"Sal17";"Onival";"199006A-T1Onival";"22.07.90";138;7;131;38;93;0,290076336
"266";"Sal3";"Ovaria";"199007A-L1Ovaria";"22.07.90";154;4;150;34;116;0,226666667
"267";"Sal3";"Onigri";"199007N1-P1Onigri";"22.07.90";11;4;7;1;6;0,142857143
"268";"Sal16";"Odolic";"199007R1-V1Odolic";"18.07.90";50;26;24;12;12;0,5
"269";"Sal28";"Oherba";"199008A-ROherba";"25.07.90";54;3;51;19;32;0,37254902
"270";"Sal16";"Oarcti";"199008T-9V1Oarcti";"25.07.90";300;78;222;35;187;0,157657658
"271";"Sal16";"Oarcti";"199010A-12NOarcti";"27.07.90";439;44;395;287;108;0,726582278
"272";"Sal16";"Oarcti";"199012P-13O1Oarcti";"27.07.90";296;12;284;262;22;0,922535211
"273";"Sal14";"Osamol";"199013Q1-14Q1Osamol";"27.07.90";192;29;163;147;16;0,901840491
"274";"Sal14";"Olappl";"199014S1Olappl";"27.07.90";3;1;2;2;0;1
"275";"Sal14";"Olappo";"199015A-POlappo";"27.07.90";63;9;54;35;19;0,648148148
"276";"Sal15";"Omyrsi";"199016A-17H1Omyrsi";"28.07.90";324;19;305;161;144;0,527868852
"277";"Sal3";"Ovaria";"199017J1-18V1Ovaria";"28.07.90";268;15;253;114;139;0,450592885
"278";"Sal28";"Oherba";"199019A-22ZOherba";"28.07.90";692;18;674;193;481;0,286350148
"279";"Sal17";"Onival";"199022A1-V1Onival";"28.07.90";90;1;89;13;76;0,146067416
"280";"Sal27";"Oglabr";"199023A-25JOglabr";"29.07.90";424;72;352;101;251;0,286931818
"281";"Sal3";"Ovaria";"199025L-V1Ovaria";"29.07.90";154;14;140;9;131;0,064285714
"282";"Sal17";"Onival";"199026A-SOnival";"29.07.90";67;14;53;0;53;0
"283";"Sal16";"Oarcti";"199026U-27V1Oarcti";"29.07.90";310;79;231;30;201;0,12987013
"284";"Sal16";"Oarcti";"199028A1-29TOarcti";"01.08.90";170;52;118;33;85;0,279661017
"285";"Sal16";"Odolic";"199028A-COdolic";"29.07.90";11;0;11;5;6;0,454545455
"286";"Sal14";"Olappo";"199028E-OOlappo";"29.07.90";45;11;34;10;24;0,294117647
"287";"Sal14";"Osamol";"199028Q-SOsamol";"29.07.90";14;3;11;2;9;0,181818182
"288";"Sal14";"Olappl";"199028UOlappl";"29.07.90";4;0;4;2;2;0,5
"289";"Sal16";"Oarcti";"199028W-XOarcti";"29.07.90";9;1;8;1;7;0,125
"290";"Sal14";"Osamol";"199029A1-30TOsamol";"01.08.90";169;58;111;22;89;0,198198198
"291";"Sal16";"Odolic";"199029V-WOdolic";"01.08.90";8;3;5;5;0;1
"292";"Sal23";"Oretic";"199030V-31HOretic";"03.08.90";141;9;132;90;42;0,681818182
"293";"Sal28";"Oherba";"199031J-32V1Oherba";"03.08.90";357;23;334;227;107;0,679640719
"294";"Sal27";"Oglabr";"199033A-LOglabr";"03.08.90";48;7;41;6;35;0,146341463
"295";"Sal27";"Oglabr";"199033N-34XOglabr";"05.08.90";237;70;167;20;147;0,119760479
"296";"Sal17";"Onival";"199034A1-U1Onival";"05.08.90";85;26;59;22;37;0,372881356
"297";"Sal3";"Ovaria";"199035A-J1Ovaria";"05.08.90";134;28;106;49;57;0,462264151
"298";"Sal14";"Olappo";"199035L1-V1Olappo";"05.08.90";29;1;28;16;12;0,571428571
"299";"Sal14";"Osamol";"199036A-37O1Osamol";"05.08.90";357;24;333;40;293;0,12012012
"300";"Sal14";"Elappo";"199037Q1-T1Elappo";"05.08.90";36;0;36;0;36;0
"301";"Sal14";"Olappl";"199037U1Olappl";"05.08.90";6;1;5;3;2;0,6
"302";"Sal27";"Oglabr";"199038A-V1Oglabr";"06.08.90";181;35;146;6;140;0,04109589
"303";"Sal14";"Olappo";"199039A-V1Olappo";"06.08.90";187;6;181;111;70;0,613259669
"304";"Sal14";"Osamol";"199040A-JOsamol";"06.08.90";40;3;37;4;33;0,108108108
"305";"Sal14";"Olappl";"199040L-MOlappl";"06.08.90";11;1;10;5;5;0,5
"306";"Sal14";"Elappo";"199040O-P1Elappo";"06.08.90";112;20;92;0;92;0
"307";"Sal17";"Onival";"199041A-O1Onival";"06.08.90";165;33;132;45;87;0,340909091
"308";"Sal17";"Eboreo";"199041Q1-V1Eboreo";"06.08.90";32;15;17;0;17;0
"309";"Sal14";"Elappo";"199042A1-43V1Elappo";"08.08.90";397;0;397;0;397;0
"310";"Sal17";"Oglauc";"199042A-ZOglauc";"06.08.90";106;35;71;45;26;0,633802817
"311";"Sal14";"Olappo";"199044A-P1Olappo";"08.08.90";168;4;164;105;59;0,640243902
"312";"Sal14";"Olappl";"199044R1-V1Olappl";"08.08.90";18;8;10;8;2;0,8
"313";"Sal8";"Eboreo";"199213H1-14I1Eboreo";"28.08.92";253;73;180;39;141;0,216666667
"314";"Sal8";"Onival";"199213W-F1Onival";"28.08.92";40;1;39;29;10;0,743589744
"315";"Sal4";"Egemmf";"199214K1-V1Egemmf";"28.08.92";62;5;57;6;51;0,105263158
"316";"Sal5";"Ehasta";"199215A-BEhasta";"28.08.92";7;0;7;1;6;0,142857143
"317";"Sal7";"Egemmh";"199215D-UEgemmh";"28.08.92";89;18;71;29;42;0,408450704
"318";"Sal7";"Egemmh";"199216A-HEgemmh";"29.08.92";40;11;29;8;21;0,275862069
"319";"Sal7";"Egemmh";"199216J-QEgemmh";"30.08.92";41;10;31;13;18;0,419354839
"320";"Sal2";"Hspira";"199216P1-17JHspira";"30.08.92";107;25;82;12;70;0,146341463
"321";"Sal2";"Obridg";"199216S-N1Obridg";"30.08.92";87;16;71;18;53;0,253521127
"322";"Sal22";"Obrevi";"199217L-V1Obrevi";"01.09.92";149;1;148;56;92;0,378378378
"323";"Sal5";"Ohasta";"199218A-IOhasta";"01.09.92";35;1;34;6;28;0,176470588
"324";"Sal5";"Ehasta";"199218K-V1Ehasta";"01.09.92";184;58;126;10;116;0,079365079
"325";"Sal3";"Ovaria";"199219A-KOvaria";"01.09.92";46;0;46;8;38;0,173913043
"326";"Sal4";"Egemmf";"199219B1-D1Egemmf";"01.09.92";17;3;14;4;10;0,285714286
"327";"Sal8";"Onival";"199219F1-20ROnival";"02.09.92";105;5;100;8;92;0,08
"328";"Sal3";"Emyrsi";"199219M-ZEmyrsi";"01.09.92";67;24;43;5;38;0,11627907
"329";"Sal7";"Egemmh";"199220T-21H1Egemmh";"02.09.92";316;73;243;34;209;0,139917695
"330";"Sal24";"Oretus";"199221J1-N1Oretus";"03.09.92";17;0;17;9;8;0,529411765
"331";"Sal23";"Oretic";"199221P1-S1Oretic";"03.09.92";13;0;13;6;7;0,461538462
"332";"Sal7";"Egemmh";"199222A1-S1Egemmh";"04.09.92";96;31;65;3;62;0,046153846
"333";"Sal7";"Egemmh";"199222A-FEgemmh";"03.09.92";31;17;14;2;12;0,142857143
"334";"Sal3";"Ovaria";"199222H-YOvaria";"04.09.92";73;2;71;20;51;0,281690141
"335";"Sal4";"Egemmf";"199223A-PEgemmf";"04.09.92";80;5;75;13;62;0,173333333
"336";"Sal21";"Hcarin";"199223M1Hcarin";"04.09.92";7;1;6;2;4;0,333333333
"337";"Sal7";"Hspirh";"199223O1-24MHspirh";"02.09.92";139;54;85;32;53;0,376470588
"338";"Sal4";"Ofoeti";"199223R-TOfoeti";"04.09.92";15;1;14;4;10;0,285714286
"339";"Sal4";"Oobscu";"199223V-K1Oobscu";"04.09.92";80;9;71;13;58;0,183098592
"340";"Sal7";"Hspirh";"199224F1-G1Hspirh";"03.09.92";16;5;11;2;9;0,181818182
"341";"Sal8";"Hplicg";"199224O-D1Hplicg";"02.09.92";101;21;80;24;56;0,3
"342";"Sal5";"Ehasta";"199301A-2NEhasta";"01.08.93";372;17;355;2;353;0,005633803
"343";"Sal27";"Elanat";"199302D1-I1Elanat";"01.08.93";33;6;27;1;26;0,037037037
"344";"Sal14";"Elappo";"199302K1-3HElappo";"01.08.93";122;28;94;57;37;0,606382979
"345";"Sal5";"Ohasta";"199302P-B1Ohasta";"01.08.93";51;11;40;26;14;0,65
"346";"Sal17";"Onival";"199303B1-D1Onival";"01.08.93";12;0;12;4;8;0,333333333
"347";"Sal27";"Elanat";"199303F1-4LElanat";"06.08.93";174;25;149;72;77;0,483221477
"348";"Sal14";"Osamol";"199303J-SOsamol";"01.08.93";39;5;34;5;29;0,147058824
"349";"Sal14";"Olappl";"199303UOlappl";"01.08.93";3;0;3;2;1;0,666666667
"350";"Sal17";"Eboreo";"199303W-ZEboreo";"01.08.93";23;7;16;9;7;0,5625
"351";"Sal3";"Ovaria";"199304J1-T1Ovaria";"06.08.93";42;0;42;4;38;0,095238095
"352";"Sal27";"Oglabr";"199304N-H1Oglabr";"06.08.93";85;2;83;2;81;0,024096386
"353";"Sal16";"Oarcti";"199305A-OOarcti";"06.08.93";59;1;58;5;53;0,086206897
"354";"Sal30";"Omyrti";"199305D1-6LOmyrti";"05.08.93";153;6;147;76;71;0,517006803
"355";"Sal3";"Hischn";"199305QHischn";"06.08.93";2;0;2;0;2;0
"356";"Sal27";"Elanat";"199305S-UElanat";"05.08.93";17;3;14;10;4;0,714285714
"357";"Sal14";"Elappo";"199305W-B1Elappo";"05.08.93";36;2;34;9;25;0,264705882
"358";"Sal16";"Ephyli";"199306N-U1Ephyli";"07.08.93";204;31;173;98;75;0,566473988
"359";"Sal16";"Oarcti";"199307A-MOarcti";"07.08.93";65;0;65;1;64;0,015384615
"360";"Sal5";"Ohasta";"199307J1-K1Ohasta";"07.08.93";7;0;7;1;6;0,142857143
"361";"Sal27";"Elanat";"199307M1-V1Elanat";"07.08.93";42;2;40;11;29;0,275
"362";"Sal16";"Odolic";"199307OOdolic";"07.08.93";7;0;7;0;7;0
"363";"Sal5";"Ehasta";"199307Q-H1Ehasta";"07.08.93";109;15;94;61;33;0,64893617
"364";"Sal27";"Elanat";"199308A-PElanat";"08.08.93";96;14;82;39;43;0,475609756
"365";"Sal27";"Oglabr";"199308TOglabr";"08.08.93";5;0;5;0;5;0
"366";"Sal14";"Elappo";"199308V-R1Elappo";"09.08.93";135;22;113;80;33;0,707964602
"367";"Sal14";"Osamol";"199309A-JOsamol";"09.08.93";48;0;48;3;45;0,0625
"368";"Sal14";"Olappl";"199309L-MOlappl";"09.08.93";8;1;7;1;6;0,142857143
"369";"Sal17";"Eboreo";"199309O-T1Eboreo";"09.08.93";193;32;161;102;59;0,633540373
"370";"Sal17";"Onival";"199310A-GOnival";"09.08.93";26;0;26;11;15;0,423076923
"371";"Sal17";"Eboreo";"199310I-U1Eboreo";"11.08.93";231;3;228;88;140;0,385964912
"372";"Sal17";"Onival";"199311A-NOnival";"11.08.93";53;1;52;26;26;0,5
"373";"Sal5";"Ehasta";"199311P-V1Ehasta";"11.08.93";186;12;174;4;170;0,022988506
"374";"Sal5";"Ohasta";"199312A-VOhasta";"11.08.93";87;0;87;53;34;0,609195402
"375";"Sal16";"Oarcti";"199312P1-13GOarcti";"11.08.93";56;5;51;7;44;0,137254902
"376";"Sal16";"Ephyli";"199312X-N1Ephyli";"11.08.93";100;8;92;0;92;0
"377";"Sal16";"Hnudip";"199313IHnudip";"11.08.93";3;0;3;0;3;0
"378";"Sal16";"Odolic";"199313K-NOdolic";"11.08.93";16;0;16;12;4;0,75
"379";"Sal3";"Emyrsi";"199313P-14PEmyrsi";"11.08.93";292;4;288;0;288;0
"380";"Sal3";"Ovaria";"199314D1-O1Ovaria";"11.08.93";48;3;45;7;38;0,155555556
"381";"Sal18";"Hleuco";"199314Q1-R1Hleuco";"12.08.93";9;0;9;0;9;0
"382";"Sal3";"Hischn";"199314R-THischn";"11.08.93";9;0;9;2;7;0,222222222
"383";"Sal3";"Onigri";"199314V-B1Onigri";"11.08.93";28;6;22;19;3;0,863636364
"384";"Sal18";"Obridg";"199315A-HObridg";"13.08.93";30;0;30;23;7;0,766666667
"385";"Sal18";"Evenus";"199315J-PEvenus";"13.08.93";21;2;19;1;18;0,052631579
"386";"Sal14";"Elappo";"199315R-XElappo";"13.08.93";42;6;36;0;36;0
"387";"Sal14";"Elappc";"199315Y-ZElappc";"13.08.93";6;0;6;0;6;0
"388";"Sal14";"Hacuti";"199316A1-V1Hacuti";"15.08.93";212;40;172;0;172;0
"389";"Sal17";"Oglauc";"199318A1-V1Oglauc";"14.08.93";90;3;87;70;17;0,804597701
"390";"Sal17";"Onival";"199319A-HOnival";"14.08.93";31;9;22;13;9;0,590909091
"391";"Sal14";"Elappc";"199319H1-I1Elappc";"14.08.93";8;0;8;0;8;0
"392";"Sal14";"Elappo";"199319J-F1Elappo";"14.08.93";137;26;111;69;42;0,621621622
"393";"Sal14";"Olappl";"199319K1-T1Olappl";"14.08.93";52;2;50;29;21;0,58
"394";"Sal14";"Hplicl";"199319V1Hplicl";"14.08.93";2;0;2;0;2;0
"395";"Sal14";"Elappc";"199320A-JElappc";"15.08.93";38;8;30;23;7;0,766666667
"396";"Sal14";"Olappl";"199320D1-G1Olappl";"15.08.93";16;1;15;13;2;0,866666667
"397";"Sal17";"Eboreo";"199320I1-P1Eboreo";"15.08.93";47;8;39;24;15;0,615384615
"398";"Sal14";"Elappo";"199320L-NElappo";"15.08.93";16;4;12;7;5;0,583333333
"399";"Sal14";"Osamol";"199320P-B1Osamol";"15.08.93";52;2;50;33;17;0,66
"400";"Sal14";"Elappc";"199321A-OElappc";"15.08.93";59;0;59;13;46;0,220338983
"401";"Sal14";"Elappo";"199321Q-22HElappo";"15.08.93";237;16;221;72;149;0,325791855
"402";"Sal14";"Olappl";"199322J-23MOlappl";"15.08.93";207;6;201;165;36;0,820895522
"403";"Sal14";"Olappl";"199323A1-V1Olappl";"15.08.93";89;0;89;47;42;0,528089888
"404";"Sal14";"Hacuti";"199323O-YHacuti";"15.08.93";86;40;46;0;46;0
"405";"Sal27";"Elanat";"199324A1-O1Elanat";"16.08.93";90;12;78;33;45;0,423076923
"406";"Sal14";"Elappo";"199324A-JElappo";"15.08.93";61;12;49;20;29;0,408163265
"407";"Sal14";"Elappc";"199324L-TElappc";"15.08.93";37;3;34;16;18;0,470588235
"408";"Sal27";"Oglabr";"199324Q1-25DOglabr";"16.08.93";37;0;37;12;25;0,324324324
"409";"Sal16";"Odolic";"199324V-ZOdolic";"15.08.93";21;0;21;2;19;0,095238095
"410";"Sal14";"Elappc";"199325A1-26RElappc";"16.08.93";160;22;138;17;121;0,123188406
"411";"Sal17";"Eboreo";"199325F-XEboreo";"16.08.93";115;0;115;0;115;0
"412";"Sal14";"Elappo";"199326T-V1Elappo";"16.08.93";176;5;171;0;171;0
"413";"Sal14";"Osamol";"199327A-LOsamol";"16.08.93";48;1;47;20;27;0,425531915
"414";"Sal14";"Olappo";"199327N-SOlappo";"16.08.93";24;2;22;5;17;0,227272727
"415";"Sal18";"Evenus";"199327U-28PEvenus";"16.08.93";177;53;124;35;89;0,282258065
"416";"Sal18";"Ogalla";"199328A1-B1Ogalla";"16.08.93";7;0;7;0;7;0
"417";"Sal18";"Hleuco";"199328D1Hleuco";"16.08.93";4;0;4;0;4;0
"418";"Sal18";"Enigri";"199328F1-L1Enigri";"16.08.93";41;19;22;0;22;0
"419";"Sal18";"Obridg";"199328R-YObridg";"16.08.93";34;1;33;25;8;0,757575758
"420";"Sal17";"Oglauc";"199329A1-30SOglauc";"19.08.93";165;18;147;21;126;0,142857143
"421";"Sal17";"Eboreo";"199329A-ZEboreo";"19.08.93";158;15;143;0;143;0
"422";"Sal16";"Odolic";"199330H1-N1Odolic";"19.08.93";28;0;28;7;21;0,25
"423";"Sal16";"Oarcti";"199330P1-31GOarcti";"19.08.93";57;6;51;3;48;0,058823529
"424";"Sal17";"Onival";"199330U-F1Onival";"19.08.93";49;7;42;15;27;0,357142857
"425";"Sal14";"Elappc";"199331F1-33UElappc";"19.08.93";344;42;302;8;294;0,026490066
"426";"Sal27";"Elanat";"199331I-RElanat";"19.08.93";57;44;13;1;12;0,076923077
"427";"Sal27";"Oglabr";"199331T-D1Oglabr";"19.08.93";42;4;38;9;29;0,236842105
"428";"Sal14";"Elappo";"199333W-34LElappo";"19.08.93";230;13;217;3;214;0,013824885
"429";"Sal14";"Olappo";"199334N-P1Olappo";"19.08.93";114;5;109;28;81;0,256880734
"430";"Sal14";"Olappl";"199334R1-T1Olappl";"19.08.93";18;0;18;2;16;0,111111111
"431";"Sal14";"Etesta";"199334V1Etesta";"19.08.93";4;0;4;0;4;0
"432";"Sal18";"Ogalla";"199335A1-B1Ogalla";"20.08.93";8;0;8;3;5;0,375
"433";"Sal18";"Evenus";"199335A-YEvenus";"20.08.93";97;26;71;32;39;0,450704225
"434";"Sal17";"Eboreo";"199335D1-36FEboreo";"22.08.93";114;12;102;57;45;0,558823529
"435";"Sal17";"Onival";"199336H-KOnival";"22.08.93";15;0;15;11;4;0,733333333
"436";"Sal14";"Elappo";"199336M-37KElappo";"22.08.93";283;23;260;122;138;0,469230769
"437";"Sal14";"Osamol";"199337A1-C1Osamol";"22.08.93";14;0;14;0;14;0
"438";"Sal14";"Olappl";"199337E1-L1Olappl";"22.08.93";50;3;47;30;17;0,638297872
"439";"Sal14";"Elappc";"199337M-RElappc";"22.08.93";24;3;21;13;8;0,619047619
"440";"Sal17";"Eboreo";"199337N1-38OEboreo";"24.08.93";143;20;123;15;108;0,12195122
"441";"Sal14";"Olappo";"199337T-ZOlappo";"22.08.93";30;1;29;18;11;0,620689655
"442";"Sal14";"Elappo";"199338A1-39CElappo";"24.08.93";149;16;133;20;113;0,15037594
"443";"Sal14";"Osamol";"199338Q-ZOsamol";"24.08.93";38;3;35;6;29;0,171428571
"444";"Sal14";"Elappc";"199339E-GElappc";"24.08.93";9;3;6;2;4;0,333333333
"445";"Sal14";"Olappl";"199339I-KOlappl";"24.08.93";13;2;11;5;6;0,454545455
"446";"Sal14";"Olappo";"199339M-OOlappo";"24.08.93";13;0;13;2;11;0,153846154
"447";"Sal14";"Hacuti";"199339Q-WHacuti";"24.08.93";42;4;38;1;37;0,026315789
"448";"Sal18";"Hleuco";"199401A1-D1Hleuco";"10.07.94";8;0;8;1;7;0,125
"449";"Sal9";"Hpruss";"199401F1-Q1Hpruss";"12.07.94";23;2;21;1;20;0,047619048
"450";"Sal9";"Hpruss";"199401M-WHpruss";"12.07.94";23;8;15;1;14;0,066666667
"451";"Sal6";"Hplicd";"199404A-UHplicd";"07.08.94";61;6;55;20;35;0,363636364
"452";"Sal6";"Edaphn";"199404F1-I1Edaphn";"07.08.94";23;10;13;12;1;0,923076923
"453";"Sal13";"Ocolla";"198650A-N1Ocolla";"05.08.86";159;1;158;100;58;0,632911392
"454";"Sal13";"Ocolla";"198651A-UOcolla";"05.08.86";83;0;83;43;40;0,518072289
"455";"Sal6";"Oadaph";"198651W-52SOadaph";"05.08.86";88;2;86;58;28;0,674418605
"456";"Sal11";"Oproxi";"198652U-R1Oproxi";"05.08.86";48;0;48;43;5;0,895833333
"457";"Sal13";"Ocolla";"198653A-V1Ocolla";"12.08.86";181;0;181;78;103;0,430939227
"458";"Sal6";"Oadaph";"198654A-V1Oadaph";"20.08.86";154;0;154;51;103;0,331168831
"459";"Sal13";"Ocolla";"198655A-JOcolla";"01.09.86";48;0;48;29;19;0,604166667
"460";"Sal11";"Oproxi";"198667A-V1Oproxi";"22.09.86";141;8;133;112;21;0,842105263
"461";"Sal10";"Ovimin";"198677A1-I1Ovimin";"24.09.86";11;0;11;7;4;0,636363636
"462";"Sal12";"Oproxi";"1986SZ4Oproxi";"11.06.86";100;0;100;5;95;0,05
"463";"Sal10";"Ovimin";"198702A-I1Ovimin";"22.06.87";31;0;31;26;5;0,838709677
"464";"Sal10";"Oviril";"198703A-K+S-AOviril";"22.06.87";117;5;112;16;96;0,142857143
"465";"Sal10";"Oviril";"198703A-KOviril";"22.06.87";12;0;12;12;0;1
"466";"Sal12";"Oproxi";"198703M-A1Oproxi";"07.07.87";29;0;29;14;15;0,482758621
"467";"Sal12";"Oproxi";"198704A-V1Oproxi";"07.07.87";48;0;48;48;0;1
"468";"Sal1";"Oelaea";"198705A-7V1Oelaea";"18.07.87";432;44;388;346;42;0,891752577
"469";"Sal1";"Okriec";"198708A-POkriec";"18.07.87";64;0;64;7;57;0,109375
"470";"Sal6";"Oadaph";"198708R-XOadaph";"18.07.87";21;0;21;19;2;0,904761905
"471";"Sal1";"Okriec";"198708Z-V1Okriec";"18.07.87";92;0;92;42;50;0,456521739
"472";"Sal1";"Okriec";"198709A-M1Okriec";"18.07.87";156;39;117;90;27;0,769230769
"473";"Sal1";"Oelaea";"198709O1-V1Oelaea";"18.07.87";24;3;21;19;2;0,904761905
"474";"Sal10";"Ovesic";"198710A-V1Ovesic";"18.07.87";92;4;88;40;48;0,454545455
"475";"Sal3";"Ovaria";"198711A1-O1Ovaria";"18.07.87";60;0;60;9;51;0,15
"476";"Sal10";"Ovimin";"198711A-ZOvimin";"18.07.87";104;0;104;58;46;0,557692308
"477";"Sal6";"Oadaph";"198711Q1-V1Oadaph";"18.07.87";30;1;29;15;14;0,517241379
"478";"Sal3";"Ovaria";"198712A-V1Ovaria";"20.07.87";144;23;121;98;23;0,809917355
"479";"Sal10";"Ovimin";"198713A-N1Ovimin";"20.07.87";120;0;120;96;24;0,8
"480";"Sal10";"Ovesic";"198713P1-V1Ovesic";"20.07.87";21;2;19;6;13;0,315789474
"481";"Sal1";"Eelaea";"199404K1-5TEelaea";"07.08.94";126;0;126;4;122;0,031746032
"482";"Sal6";"Oadaph";"199404W-D1Oadaph";"07.08.94";32;1;31;28;3;0,903225806
"483";"Sal1";"Eelaea";"199405V-V1Eelaea";"07.08.94";120;0;120;2;118;0,016666667
"484";"Sal19";"Hischn";"199406A-E1Hischn";"08.08.94";180;25;155;18;137;0,116129032
"485";"Sal19";"Ovaria";"199406G1-7DOvaria";"08.08.94";98;1;97;58;39;0,597938144
"486";"Sal19";"Emyrsi";"199407F-8WEmyrsi";"08.08.94";398;193;205;2;203;0,009756098
"487";"Sal19";"Hischn";"199408A1-9IHischn";"09.08.94";302;71;231;15;216;0,064935065
"488";"Sal19";"Onigri";"199409A1-10E1Onigri";"09.08.94";211;17;194;101;93;0,520618557
"489";"Sal19";"Ovaria";"199409K-XOvaria";"09.08.94";56;4;52;32;20;0,615384615
"490";"Sal5";"Ehasta";"199410K1-V1Ehasta";"09.08.94";74;22;52;1;51;0,019230769
"491";"Sal20";"Egemmf";"199411A-H1Egemmf";"09.08.94";204;21;183;0;183;0
"492";"Sal20";"Ofoeti";"199411J1-12EOfoeti";"09.08.94";72;4;68;12;56;0,176470588
"493";"Sal2";"Hspira";"199412A1-G1Hspira";"10.08.94";60;20;40;18;22;0,45
"494";"Sal20";"Oobscu";"199412G-JOobscu";"09.08.94";15;2;13;7;6;0,538461538
"495";"Sal20";"Ofoeti";"199412I1-R1Ofoeti";"10.08.94";41;1;40;27;13;0,675
"496";"Sal3";"Emyrsi";"199412L-XEmyrsi";"09.08.94";79;4;75;3;72;0,04
"497";"Sal20";"Oobscu";"199412T1-V1Oobscu";"10.08.94";15;0;15;6;9;0,4
"498";"Sal20";"Omonti";"199413A-M1Omonti";"10.08.94";157;9;148;51;97;0,344594595
"499";"Sal20";"Egemmf";"199413O1-V1Egemmf";"10.08.94";59;7;52;2;50;0,038461538
"500";"Sal6";"Hplicd";"199414A-BHplicd";"11.08.94";37;12;25;8;17;0,32
"501";"Sal12";"Oproxi";"199414D1-15ZOproxi";"11.08.94";198;31;167;53;114;0,317365269
"502";"Sal6";"Edaphn";"199414D-REdaphn";"11.08.94";89;12;77;2;75;0,025974026
"503";"Sal6";"Oadaph";"199414T-B1Oadaph";"11.08.94";35;0;35;32;3;0,914285714
"504";"Sal10";"Ovesic";"199415A1-16MOvesic";"11.08.94";140;10;130;79;51;0,607692308
"505";"Sal10";"Hpolit";"199416A1-V1Hpolit";"11.08.94";232;117;115;14;101;0,12173913
"506";"Sal10";"Ovimin";"199416O-VOvimin";"11.08.94";32;5;27;23;4;0,851851852
"507";"Sal1";"Okriec";"199417A1-E1Okriec";"12.08.94";20;2;18;17;1;0,944444444
"508";"Sal6";"Hplicd";"199417A-HHplicd";"12.08.94";81;51;30;19;11;0,633333333
"509";"Sal2";"Obridg";"199417I1-Q1Obridg";"09.08.94";21;4;17;9;8;0,529411765
"510";"Sal6";"Oadaph";"199417J-WOadaph";"12.08.94";54;0;54;25;29;0,462962963
"511";"Sal1";"Eelaea";"199418A-I1Eelaea";"12.08.94";104;9;95;8;87;0,084210526
"512";"Sal1";"Eelaea";"199418K1-19YEelaea";"11.08.94";123;0;123;2;121;0,016260163
"513";"Sal10";"Ovimin";"199420A1-U1Ovimin";"11.09.94";84;0;84;39;45;0,464285714
"514";"Sal10";"Epurpu";"199420A-KEpurpu";"11.09.94";42;9;33;5;28;0,151515152
"515";"Sal10";"Ovesic";"199420M-ZOvesic";"11.09.94";44;0;44;15;29;0,340909091
"516";"Sal10";"Ovesic";"199421A-O1Ovesic";"11.09.94";123;11;112;23;89;0,205357143
"517";"Sal7";"Egemmh";"199421Q1-R1Egemmh";"11.09.94";9;3;6;0;6;0
"518";"Sal7";"Egemmh";"199422A-23C1Egemmh";"11.09.94";458;95;363;56;307;0,154269972
"519";"Sal7";"Omacul";"199423E1-H1Omacul";"11.09.94";17;0;17;12;5;0,705882353
"520";"Sal8";"Eboreo";"199423J1-S1Eboreo";"11.09.94";56;30;26;7;19;0,269230769
"521";"Sal5";"Ohasta";"199424A1-F1Ohasta";"11.09.94";24;2;22;2;20;0,090909091
"522";"Sal8";"Onival";"199424A-POnival";"11.09.94";60;18;42;30;12;0,714285714
"523";"Sal3";"Ovaria";"199424H1-O1Ovaria";"12.09.94";24;1;23;8;15;0,347826087
"524";"Sal7";"Egemmh";"199424Q1-V1Egemmh";"12.09.94";25;8;17;2;15;0,117647059
"525";"Sal5";"Ehasta";"199424R-XEhasta";"11.09.94";40;8;32;7;25;0,21875
"526";"Sal4";"Egemmf";"199425A1-D1Egemmf";"12.09.94";24;0;24;6;18;0,25
"527";"Sal5";"Ohasta";"199425A-BOhasta";"12.09.94";7;0;7;2;5;0,285714286
"528";"Sal5";"Ehasta";"199425D-GEhasta";"12.09.94";24;5;19;6;13;0,315789474
"529";"Sal10";"Ovimin";"199425F1-V1Ovimin";"12.09.94";78;0;78;63;15;0,807692308
"530";"Sal22";"Obrevi";"199425I-LObrevi";"12.09.94";17;4;13;8;5;0,615384615
"531";"Sal4";"Ofoeti";"199425N-YOfoeti";"12.09.94";37;2;35;10;25;0,285714286
"532";"Sal10";"Epurpu";"199426A-K1Epurpu";"12.09.94";145;17;128;32;96;0,25
"533";"Sal6";"Oadaph";"199426M1-27MOadaph";"12.09.94";69;0;69;16;53;0,231884058
"534";"Sal6";"Edaphn";"199427O-QEdaphn";"13.09.94";19;3;16;3;13;0,1875
"535";"Sal6";"Oadaph";"199427S-V1Oadaph";"13.09.94";70;0;70;4;66;0,057142857
"536";"Sal10";"Ovesic";"199428A-TOvesic";"13.09.94";59;1;58;13;45;0,224137931
"537";"Sal5";"Ohasta";"199428I1-V1Ohasta";"13.09.94";52;2;50;2;48;0,04
"538";"Sal10";"Epurpu";"199428V-G1Epurpu";"13.09.94";37;7;30;9;21;0,3
"539";"Sal24";"Oretus";"199429A-EOretus";"13.09.94";15;0;15;9;6;0,6
"540";"Sal4";"Ofoeti";"199429G-MOfoeti";"13.09.94";27;0;27;7;20;0,259259259
"541";"Sal1";"Okriec";"199429O1-30COkriec";"13.09.94";44;0;44;21;23;0,477272727
"542";"Sal4";"Oobscu";"199429O-M1Oobscu";"13.09.94";100;11;89;53;36;0,595505618
"543";"Sal1";"Okriec";"199430A-COkriec";"13.09.94";12;0;12;0;12;0
"544";"Sal10";"Ovesic";"199430E-TOvesic";"13.09.94";48;0;48;23;25;0,479166667
"545";"Sal1";"Eelaea";"199430V-31VEelaea";"13.09.94";151;0;151;5;146;0,033112583
"546";"Sal10";"Epurpu";"199431M1-T1Epurpu";"13.09.94";31;6;25;7;18;0,28
"547";"Sal10";"Ovimin";"199431X-K1Ovimin";"13.09.94";57;0;57;20;37;0,350877193
"548";"Sal1";"Eelaea";"199432A1-33IEelaea";"15.09.94";120;7;113;18;95;0,159292035
"549";"Sal10";"Ovimin";"199432A-VOvimin";"15.09.94";88;1;87;22;65;0,252873563
"550";"Sal1";"Eelaea";"199433A-IEelaea";"15.09.94";32;0;32;0;32;0
"551";"Sal1";"Okriec";"199433K-NOkriec";"15.09.94";16;0;16;5;11;0,3125
"552";"Sal6";"Edaphn";"199433P-SEdaphn";"16.09.94";18;3;15;9;6;0,6
"553";"Sal10";"Epurpu";"199433Q1-34UEpurpu";"16.09.94";106;9;97;14;83;0,144329897
"554";"Sal6";"Oadaph";"199433U-O1Oadaph";"16.09.94";62;1;61;27;34;0,442622951
"555";"Sal25";"Emucro";"199435A-ZEmucro";"06.10.94";156;0;156;16;140;0,102564103
"556";"Sal11";"Eatraa";"199436A-BEatraa";"19.10.94";7;0;7;1;6;0,142857143
"557";"Sal11";"Eatraa";"199436D-VEatraa";"19.10.94";52;6;46;10;36;0,217391304
"558";"Sal31";"Eangus";"199436XEangus";"19.10.94";1;0;1;0;1;0
"559";"Sal11";"Eatraa";"199452A-LEatraa";"06.04.95";38;0;38;9;29;0,236842105
"560";"Sal10";"Epurpu";"199452O-TEpurpu";"06.04.95";23;0;23;5;18;0,217391304
"561";"Sal31";"Hangli";"199500A-V1Hangli";"03.07.95";21;5;16;0;16;0
"562";"Sal9";"Hleuca";"199506A1-7CHleuca";"02.07.95";163;87;76;1;75;0,013157895
"563";"Sal10";"Hpolit";"199506aA-EHpolit";"27.06.95";30;9;21;0;21;0
"564";"Sal10";"Hpolit";"199506A-E/aHpolit";"27.06.95";14;7;7;0;7;0
"565";"Sal10";"Hpolit";"199506A-E/bHpolit";"27.06.95";30;9;21;1;20;0,047619048
"566";"Sal10";"Hpolit";"199506A-EHpolit";"27.06.95";47;20;27;3;24;0,111111111
"567";"Sal12";"Hoblit";"199506G-HHoblit";"27.06.95";13;4;9;0;9;0
"568";"Sal9";"Hleuca";"199506J-RHleuca";"27.06.95";183;65;118;3;115;0,025423729
"569";"Sal10";"Hpolit";"199506S-UHpolit";"02.07.95";49;4;45;7;38;0,155555556
"570";"Sal12";"Hoblit";"199507A1-E1Hoblit";"04.07.95";46;6;40;0;40;0
"571";"Sal25";"Heryth";"199507E-NHeryth";"02.07.95";104;42;62;0;62;0
"572";"Sal31";"Hangli";"199507G1Hangli";"04.07.95";5;1;4;0;4;0
"573";"Sal25";"Halien";"199507O-QHalien";"02.07.95";42;9;33;2;31;0,060606061
"574";"Sal18";"Hleuco";"199508A1-E1Hleuco";"04.07.95";43;16;27;1;26;0,037037037
"575";"Sal10";"Hpolit";"199508A-LHpolit";"04.07.95";153;61;92;6;86;0,065217391
"576";"Sal18";"Obridg";"199508G1Obridg";"04.07.95";5;0;5;1;4;0,2
"577";"Sal31";"Hangli";"199508N-QHangli";"04.07.95";74;20;54;2;52;0,037037037
"578";"Sal9";"Hleuca";"199508S-VHleuca";"04.07.95";25;9;16;0;16;0
"579";"Sal18";"Ogalla";"199509A-BOgalla";"04.07.95";26;0;26;3;23;0,115384615
"580";"Sal25";"Halien";"199509CHalien";"04.07.95";11;1;10;0;10;0
"581";"Sal9";"Obridg";"199509F-LObridg";"12.07.95";26;0;26;17;9;0,653846154
"582";"Sal5";"Ehasta";"199510A1-M1Ehasta";"27.07.95";66;8;58;40;18;0,689655172
"583";"Sal5";"Ohasta";"199510A-VOhasta";"27.07.95";86;1;85;27;58;0,317647059
"584";"Sal10";"Ovimin";"199510O1-T1Ovimin";"26.07.95";30;0;30;10;20;0,333333333
"585";"Sal4";"Oobscu";"199511A-COobscu";"27.07.95";15;0;15;12;3;0,8
"586";"Sal2";"Obridg";"199511E-GObridg";"24.07.95";14;0;14;9;5;0,642857143
"587";"Sal10";"Ovesic";"199511G1-V1Ovesic";"26.07.95";80;0;80;34;46;0,425
"588";"Sal2";"Obridg";"199511I-NObridg";"25.07.95";27;1;26;14;12;0,538461538
"589";"Sal2";"Obridg";"199511P-QObridg";"29.07.95";11;0;11;7;4;0,636363636
"590";"Sal10";"Ovimin";"199511S-E1Ovimin";"26.07.95";62;0;62;23;39;0,370967742
"591";"Sal8";"Onival";"199512A-COnival";"29.07.95";13;0;13;4;9;0,307692308
"592";"Sal8";"Onival";"199512E-FOnival";"29.07.95";12;0;12;2;10;0,166666667
"593";"Sal2";"Obridg";"199512H-OObridg";"27.07.95";37;0;37;22;15;0,594594595
"594";"Sal7";"Egemmh";"199513A-V1Egemmh";"10.09.95";277;35;242;26;216;0,107438017
"595";"Sal7";"Omacul";"199514A-JOmacul";"10.09.95";31;0;31;13;18;0,419354839
"596";"Sal5";"Ohasta";"199514D1-L1Ohasta";"10.09.95";36;1;35;1;34;0,028571429
"597";"Sal8";"Onival";"199514L-B1Onival";"10.09.95";49;3;46;6;40;0,130434783
"598";"Sal5";"Ehasta";"199514M1-N1Ehasta";"10.09.95";8;2;6;2;4;0,333333333
"599";"Sal10";"Ovesic";"199515A1-16TOvesic";"10.09.95";127;2;125;7;118;0,056
"600";"Sal10";"Ovimin";"199515A-XOvimin";"10.09.95";73;1;72;1;71;0,013888889
"601";"Sal4";"Oobscu";"199516J1-Q1Oobscu";"10.09.95";42;14;28;3;25;0,107142857
"602";"Sal4";"Ofoeti";"199516T1-V1Ofoeti";"10.09.95";7;0;7;2;5;0,285714286
"603";"Sal5";"Ohasta";"199516V-H1Ohasta";"10.09.95";52;3;49;5;44;0,102040816
"604";"Sal23";"Oretic";"199517A1-C1Oretic";"10.09.95";9;1;8;3;5;0,375
"605";"Sal24";"Oretus";"199517A-XOretus";"10.09.95";98;0;98;48;50;0,489795918
"606";"Sal1";"Okriec";"199517E1-L1Okriec";"11.09.95";32;0;32;2;30;0,0625
"607";"Sal6";"Edaphn";"199517N1-18CEdaphn";"11.09.95";62;21;41;3;38;0,073170732
"608";"Sal6";"Oadaph";"199518E-C1Oadaph";"13.09.95";67;2;65;12;53;0,184615385
"609";"Sal19";"Emyrsi";"199519A-S1Emyrsi";"14.09.95";231;25;206;26;180;0,126213592
"610";"Sal6";"Oadaph";"199520A1-K1Oadaph";"14.09.95";33;5;28;19;9;0,678571429
"611";"Sal19";"Emyrsi";"199520A-VEmyrsi";"14.09.95";110;1;109;12;97;0,110091743
"612";"Sal20";"Egemmf";"199520M1-21E1Egemmf";"14.09.95";238;25;213;85;128;0,399061033
"613";"Sal5";"Ehasta";"199521G1-I1Ehasta";"14.09.95";12;1;11;6;5;0,545454545
"614";"Sal10";"Hpolit";"19956bA-EHpolit";"27.06.95";14;7;7;3;4;0,428571429
"615";"Sal31";"Hangli";"1995ohneohneHangli";"04.07.95";21;5;16;0;16;0
"616";"Sal10";"Epurpu";"1995SZ?Epurpu";"01.10.95";23;0;23;0;23;0
"617";"Sal10";"Hpolit";"1995SZA1Hpolit";"12.09.95";28;8;20;0;20;0
"618";"Sal9";"Hleuca";"1995SZAHleuca";"12.07.95";75;4;71;4;67;0,056338028
"619";"Sal1";"Eelaea";"1995SZB1Eelaea";"11.09.95";177;0;177;59;118;0,333333333
"620";"Sal25";"Halien";"1995SZBHalien";"12.07.95";31;12;19;1;18;0,052631579
"621";"Sal10";"Epurpu";"1995SZC1Epurpu";"10.09.95";119;0;119;0;119;0
"622";"Sal10";"Hpolit";"1995SZCHpolit";"12.07.95";82;21;61;2;59;0,032786885
"623";"Sal1";"Eelaea";"1995SZD1Eelaea";"11.09.95";171;0;171;141;30;0,824561404
"624";"Sal9";"Hleuca";"1995SZDHleuca";"12.07.95";84;37;47;0;47;0
"625";"Sal10";"Epurpu";"1995SZE1Epurpu";"13.09.95";35;0;35;26;9;0,742857143
"626";"Sal9";"Hpruss";"1995SZEHpruss";"12.07.95";135;41;94;3;91;0,031914894
"627";"Sal12";"Eatraa";"1995SZF1Eatraa";"12.10.95";90;0;90;25;65;0,277777778
"628";"Sal9";"Hleuca";"1995SZFHleuca";"12.07.95";92;36;56;4;52;0,071428571
"629";"Sal11";"Eatraa";"1995SZG1Eatraa";"11.10.95";95;0;95;55;40;0,578947368
"630";"Sal32";"Hsglab";"1995SZGHsglab";"23.07.95";108;35;73;5;68;0,068493151
"631";"Sal12";"Eatraa";"1995SZH1Eatraa";"11.10.95";69;0;69;15;54;0,217391304
"632";"Sal32";"Hsglab";"1995SZHHsglab";"27.07.95";86;22;64;3;61;0,046875
"633";"Sal32";"Hsglab";"1995SZIHsglab";"24.07.95";43;14;29;4;25;0,137931034
"634";"Sal32";"Hsglab";"1995SZJHsglab";"24.07.95";115;46;69;7;62;0,101449275
"635";"Sal32";"Hsglab";"1995SZKHsglab";"25.07.95";213;75;138;19;119;0,137681159
"636";"Sal10";"Hpolit";"1995SZLHpolit";"26.07.95";47;14;33;8;25;0,242424242
"637";"Sal3";"Hischn";"1995SZMHischn";"26.07.95";4;2;2;1;1;0,5
"638";"Sal8";"Hplicg";"1995SZNHplicg";"29.07.95";80;18;62;12;50;0,193548387
"639";"Sal8";"Hplicg";"1995SZOHplicg";"29.07.95";66;23;43;12;31;0,279069767
"640";"Sal10";"Hpolit";"1995SZPHpolit";"26.07.95";85;23;62;0;62;0
"641";"Sal32";"Hsglab";"1995SZQHsglab";"25.07.95";77;32;45;1;44;0,022222222
"642";"Sal2";"Hspira";"1995SZRHspira";"23.07.95";59;18;41;1;40;0,024390244
"643";"Sal2";"Hspira";"1995SZSHspira";"29.07.95";34;10;24;1;23;0,041666667
"644";"Sal21";"Hcarin";"1995SZTHcarin";"29.07.95";277;89;188;55;133;0,292553191
"645";"Sal7";"Hspirh";"1995SZUHspirh";"10.09.95";84;13;71;4;67;0,056338028
"646";"Sal8";"Hplicg";"1995SZVHplicg";"10.09.95";240;68;172;22;150;0,127906977
"647";"Sal5";"Htuber";"1995SZWHtuber";"10.09.95";119;71;48;2;46;0,041666667
"648";"Sal19";"Hischn";"1995SZXHischn";"14.09.95";314;65;249;6;243;0,024096386
"649";"Sal6";"Hplicd";"1995SZYHplicd";"12.09.95";92;44;48;19;29;0,395833333
"650";"Sal6";"Hplicd";"1995SZZHplicd";"14.09.95";249;59;190;8;182;0,042105263
"651";"Sal12";"Etesta";"199601A-FEtesta";"26.07.96";35;0;35;3;32;0,085714286
"652";"Sal13";"Eweiff";"199601C1-G1/U1-V1Eweiff";"17.08.96";82;0;82;22;60;0,268292683
"653";"Sal13";"Ocolla";"199601H-OOcolla";"17.08.96";49;0;49;8;41;0,163265306
"654";"Sal13";"Ocolla";"199601Q-A1Ocolla";"17.08.96";66;0;66;33;33;0,5
"655";"Sal31";"Esubge";"199602AEsubge";"16.08.96";5;0;5;1;4;0,2
"656";"Sal12";"Oproxi";"199602C-GOproxi";"16.08.96";32;6;26;15;11;0,576923077
"657";"Sal3";"Ovaria";"199602I1-N1Ovaria";"29.08.96";32;0;32;9;23;0,28125
"658";"Sal9";"Opedun";"199602I-LOpedun";"16.08.96";25;2;23;15;8;0,652173913
"659";"Sal12";"Etesta";"199602N-G1Etesta";"16.08.96";100;28;72;44;28;0,611111111
"660";"Sal20";"Ofoeti";"199602P1-V1Ofoeti";"26.08.96";45;5;40;32;8;0,8
"661";"Sal20";"Oobscu";"199603A-BOobscu";"26.08.96";9;0;9;4;5;0,444444444
"662";"Sal33";"Ovaria";"199603D-QOvaria";"30.08.96";43;0;43;0;43;0
"663";"Sal4";"Oobscu";"199604K-LOobscu";"27.08.96";11;0;11;1;10;0,090909091
"664";"Sal11";"Eatraa";"199643A-XEatraa";"18.05.96";55;3;52;28;24;0,538461538
"665";"Sal10";"Hpolit";"1996SZ01Hpolit";"18.07.96";176;41;135;7;128;0,051851852
"666";"Sal10";"Hpolit";"1996SZ02Hpolit";"17.07.96";22;7;15;1;14;0,066666667
"667";"Sal34";"Hoblit";"1996SZ03Hoblit";"17.07.96";6;0;6;0;6;0
"668";"Sal9";"Hpruss";"1996SZ04Hpruss";"17.07.96";56;22;34;1;33;0,029411765
"669";"Sal10";"Hpolit";"1996SZ05Hpolit";"17.07.96";9;5;4;0;4;0
"670";"Sal9";"Hpruss";"1996SZ06Hpruss";"17.07.96";8;6;2;0;2;0
"671";"Sal10";"Hpolit";"1996SZ07Hpolit";"18.07.96";57;9;48;2;46;0,041666667
"672";"Sal11";"Hoblit";"1996SZ08Hoblit";"17.07.96";43;2;41;1;40;0,024390244
"673";"Sal9";"Hpruss";"1996SZ09Hpruss";"17.07.96";42;1;41;0;41;0
"674";"Sal31";"Hangli";"1996SZ10Hangli";"18.07.96";114;9;105;3;102;0,028571429
"675";"Sal31";"Hangli";"1996SZ11Hangli";"18.07.96";61;16;45;1;44;0,022222222
"676";"Sal31";"Hangli";"1996SZ12Hangli";"18.07.96";7;5;2;0;2;0
"677";"Sal31";"Hangli";"1996SZ13Hangli";"18.07.96";99;21;78;2;76;0,025641026
"678";"Sal9";"Hleuca";"1996SZ14Hleuca";"17.07.96";102;54;48;1;47;0,020833333
"679";"Sal9";"Hleuca";"1996SZ15Hleuca";"17.07.96";135;59;76;1;75;0,013157895
"680";"Sal25";"Halien";"1996SZ16Halien";"02.08.96";131;31;100;20;80;0,2
"681";"Sal25";"Heryth";"1996SZ17Heryth";"02.08.96";82;29;53;1;52;0,018867925
"682";"Sal19";"Hischn";"1996SZ18Hischn";"26.08.96";126;19;107;2;105;0,018691589
"683";"Sal19";"Hischn";"1996SZ19aHischn";"27.08.96";92;14;78;16;62;0,205128205
"684";"Sal19";"Hischn";"1996SZ19bHischn";"27.08.96";39;8;31;0;31;0
"685";"Sal3";"Hischn";"1996SZ20Hischn";"28.08.96";39;12;27;4;23;0,148148148
"686";"Sal6";"Hplicd";"1996SZ21Hplicd";"26.08.96";429;85;344;12;332;0,034883721
"687";"Sal8";"Hplicg";"1996SZ22Hplicg";"28.08.96";171;40;131;43;88;0,328244275
"688";"Sal21";"Hcarin";"1996SZ23Hcarin";"28.08.96";355;101;254;99;155;0,38976378
"689";"Sal7";"Egemmh";"1996SZ24Egemmh";"29.08.96";52;0;52;4;48;0,076923077
"690";"Sal7";"Egemmh";"1996SZ25Egemmh";"30.08.96";41;0;41;2;39;0,048780488
"691";"Sal7";"Egemmh";"1996SZ26Egemmh";"29.08.96";71;0;71;0;71;0
"692";"Sal7";"Egemmh";"1996SZ27Egemmh";"29.08.96";59;0;59;9;50;0,152542373
"693";"Sal19";"Emyrsi";"1996SZ28Emyrsi";"27.08.96";174;0;174;0;174;0
"694";"Sal20";"Egemmf";"1996SZ29Egemmf";"27.08.96";98;0;98;3;95;0,030612245
"695";"Sal5";"Ehasta";"1996SZ30Ehasta";"28.08.96";103;0;103;9;94;0,087378641
"696";"Sal8";"Eboreo";"1996SZ31Eboreo";"28.08.96";17;0;17;2;15;0,117647059
"697";"Sal20";"Egemmf";"1996SZ32Egemmf";"26.08.96";20;0;20;8;12;0,4
"698";"Sal4";"Egemmf";"1996SZ33Egemmf";"29.08.96";28;0;28;0;28;0
"699";"Sal20";"Egemmf";"1996SZ34Egemmf";"27.08.96";175;0;175;12;163;0,068571429
"700";"Sal20";"Egemmf";"1996SZ35Egemmf";"27.08.96";59;0;59;4;55;0,06779661
"701";"Sal20";"Egemmf";"1996SZ36Egemmf";"27.08.96";81;0;81;1;80;0,012345679
"702";"Sal7";"Egemmh";"1996SZ37Egemmh";"28.08.96";33;0;33;9;24;0,272727273
"703";"Sal20";"Egemmf";"1996SZ38Egemmf";"27.08.96";16;0;16;1;15;0,0625
"704";"Sal5";"Ehasta";"1996SZ39Ehasta";"30.08.96";8;0;8;0;8;0
"705";"Sal5";"Ehasta";"1996SZ40Ehasta";"27.08.96";111;0;111;4;107;0,036036036
"706";"Sal19";"Emyrsi";"1996SZ41Emyrsi";"26.08.96";45;0;45;3;42;0,066666667
"707";"Sal20";"Egemmf";"1996SZ42Egemmf";"26.08.96";71;0;71;9;62;0,126760563
"708";"Sal2";"Hspira";"1996SZ43Hspira";"30.08.96";22;7;15;4;11;0,266666667
"709";"Sal2";"Hspira";"1996SZ44Hspira";"29.08.96";27;10;17;6;11;0,352941176
"710";"Sal1";"Eelaea";"1996SZ45aEelaea";"27.08.96";66;0;66;1;65;0,015151515
"711";"Sal1";"Eelaea";"1996SZ45bEelaea";"27.08.96";152;0;152;1;151;0,006578947
"712";"Sal1";"Eelaea";"1996SZ46Eelaea";"27.08.96";24;0;24;0;24;0
"713";"Sal7";"Egemmh";"1996SZ47Egemmh";"23.09.96";260;0;260;1;259;0,003846154
"714";"Sal10";"Epurpu";"1996SZ48Epurpu";"24.09.96";43;0;43;0;43;0
"715";"Sal10";"Epurpu";"1996SZ49Epurpu";"24.09.96";117;0;117;0;117;0
"716";"Sal10";"Epurpu";"1996SZ50Epurpu";"25.09.96";30;0;30;17;13;0,566666667
"717";"Sal10";"Epurpu";"1996SZ51Epurpu";"25.09.96";48;0;48;12;36;0,25
"718";"Sal10";"Epurpu";"1996SZ52Epurpu";"24.09.96";18;0;18;6;12;0,333333333
"719";"Sal6";"Edaphn";"1996SZ53Edaphn";"26.09.96";36;0;36;3;33;0,083333333
"720";"Sal3";"Emyrsi";"1996SZ54Emyrsi";"26.09.96";133;0;133;38;95;0,285714286
"721";"Sal1";"Eelaea";"1996SZ55Eelaea";"24.09.96";107;0;107;9;98;0,08411215
"722";"Sal7";"Egemmh";"1996SZ56Egemmh";"24.09.96";207;0;207;13;194;0,062801932
"723";"Sal1";"Eelaea";"1996SZ57Eelaea";"24.09.96";204;0;204;22;182;0,107843137
"724";"Sal9";"Egemmc";"1996SZ58Egemmc";"25.09.96";158;0;158;15;143;0,094936709
"725";"Sal5";"Ehasta";"1996SZ59Ehasta";"25.09.96";5;0;5;2;3;0,4
"726";"Sal7";"Egemmh";"1996SZ60Egemmh";"25.09.96";145;0;145;3;142;0,020689655
"727";"Sal7";"Egemmh";"1996SZ61Egemmh";"24.09.96";11;0;11;1;10;0,090909091
"728";"Sal7";"Egemmh";"1996SZ62Egemmh";"23.09.96";116;0;116;17;99;0,146551724
"729";"Sal25";"Eaurit";"1996SZ63aEaurit";"28.09.96";1;0;1;0;1;0
"730";"Sal25";"Obella";"1996SZ63bObella";"28.09.96";2;0;2;0;2;0
"731";"Sal25";"Emucro";"1996SZ63Emucro";"28.09.96";112;0;112;8;104;0,071428571
"732";"Sal25";"Emucro";"1996SZ64Emucro";"28.09.96";23;0;23;4;19;0,173913043
"733";"Sal25";"Evenus";"1996SZ65Evenus";"06.10.96";15;0;15;0;15;0
"734";"Sal25";"Emucro";"1996SZ66Emucro";"06.10.96";30;0;30;0;30;0
"735";"Sal31";"Esubge";"1996SZ68Esubge";"12.10.96";2;0;2;0;2;0
"736";"Sal9";"Egemmc";"1996SZ69Egemmc";"12.10.96";25;0;25;0;25;0
"737";"Sal9";"Opedun";"1996SZ70Opedun";"12.10.96";8;0;8;0;8;0
"738";"Sal35";"Eweiff";"1996SZ71Eweiff";"14.11.96";37;21;16;7;9;0,4375
"739";"Sal15";"Ospeit";"199701A-FOspeit";"03.08.97";59;4;55;28;27;0,509090909
"740";"Sal18";"Evenus";"199701D1-H1Evenus";"03.08.97";19;1;18;1;17;0,055555556
"741";"Sal30";"Omyrti";"199701G-IOmyrti";"07.08.97";31;8;23;15;8;0,652173913
"742";"Sal18";"Evenus";"199701J1-K1Evenus";"07.08.97";8;5;3;0;3;0
"743";"Sal30";"Omyrti";"199701K-LOmyrti";"08.08.97";28;6;22;14;8;0,636363636
"744";"Sal16";"Oarcti";"199701M1-2FOarcti";"10.08.97";79;13;66;53;13;0,803030303
"745";"Sal14";"Olappl";"199701M-QOlappl";"03.08.97";21;0;21;20;1;0,952380952
"746";"Sal18";"Ospset";"199701S-B1Ospset";"07.08.97";40;0;40;26;14;0,65
"747";"Sal16";"Odolic";"199702H-V1Odolic";"08.08.97";166;55;111;79;32;0,711711712
"748";"Sal17";"Oglauc";"199703T-Z+32H-TOglauc";"03.08.97";113;21;92;53;39;0,576086957
"749";"Sal18";"Ogalla";"199703A1-H1Ogalla";"03.08.97";48;1;47;12;35;0,255319149
"750";"Sal17";"Oglauc";"199703A-ROglauc";"08.08.97";74;25;49;28;21;0,571428571
"751";"Sal3";"Ovaria";"199703J1-4TOvaria";"03.08.97";163;7;156;9;147;0,057692308
"752";"Sal17";"Oglauc";"199703T-ZOglauc";"03.08.97";38;11;27;16;11;0,592592593
"753";"Sal28";"Oherba";"199704V-V1Oherba";"02.08.97";110;1;109;25;84;0,229357798
"754";"Sal15";"Omyrsi";"199705A-DOmyrsi";"02.08.97";20;0;20;3;17;0,15
"755";"Sal15";"Omyrsi";"199705F-E1Omyrsi";"06.08.97";156;4;152;136;16;0,894736842
"756";"Sal14";"Osamol";"199705G1-V1Osamol";"10.08.97";80;0;80;15;65;0,1875
"757";"Sal28";"Oherba";"199706A-S1Oherba";"05.08.97";178;1;177;40;137;0,225988701
"758";"Sal23";"Oretic";"199707A-8GOretic";"05.08.97";277;4;273;51;222;0,186813187
"759";"Sal18";"Obridg";"199708A1-F1Obridg";"11.08.97";32;2;30;11;19;0,366666667
"760";"Sal18";"Ogalla";"199708H1-V1Ogalla";"11.08.97";113;9;104;39;65;0,375
"761";"Sal18";"Evenus";"199708I-YEvenus";"11.08.97";68;5;63;0;63;0
"762";"Sal18";"Evenus";"199709A1-10NEvenus";"14.08.97";179;20;159;0;159;0
"763";"Sal18";"Evenus";"199709A-LEvenus";"14.08.97";60;2;58;0;58;0
"764";"Sal13";"Ocolla";"199710K1-12LOcolla";"29.08.97";110;0;110;59;51;0,536363636
"765";"Sal18";"Evenus";"199710P-REvenus";"16.08.97";18;1;17;1;16;0,058823529
"766";"Sal12";"Etesta";"199710T-J1Etesta";"30.08.97";68;24;44;6;38;0,136363636
"767";"Sal16";"Odolic";"199712M-13N1Odolic";"16.08.97";456;147;309;159;150;0,514563107
"768";"Sal18";"Ogalla";"199713O1-14YOgalla";"14.08.97";197;4;193;0;193;0
"769";"Sal15";"Omyrsi";"199714A1-15K1Omyrsi";"05.08.97";258;3;255;78;177;0,305882353
"770";"Sal18";"Obridg";"199715M1-28RObridg";"14.08.97";141;4;137;90;47;0,656934307
"771";"Sal28";"Oherba";"199728T-29FOherba";"16.08.97";194;7;187;79;108;0,422459893
"772";"Sal14";"Olappo";"199729G-UOlappo";"22.08.97";104;0;104;44;60;0,423076923
"773";"Sal16";"Oarcti";"199729V-V1Oarcti";"22.08.97";126;4;122;0;122;0
"774";"Sal18";"Evenus";"199730A-LEvenus";"23.08.97";61;10;51;5;46;0,098039216
"775";"Sal27";"Oglabr";"199730F1-J1Oglabr";"22.08.97";22;5;17;0;17;0
"776";"Sal26";"Otrian";"199730K1-V1Otrian";"19.08.97";48;17;31;4;27;0,129032258
"777";"Sal17";"Onival";"199730M-UOnival";"22.08.97";34;0;34;1;33;0,029411765
"778";"Sal17";"Oglauc";"199730W-E1Oglauc";"22.08.97";54;8;46;10;36;0,217391304
"779";"Sal14";"Olappo";"199731A1-I1Olappo";"10.08.97";41;5;36;15;21;0,416666667
"780";"Sal25";"Obridg";"199731A-CObridg";"19.08.97";13;10;3;2;1;0,666666667
"781";"Sal25";"Obella";"199731D-FObella";"19.08.97";14;7;7;0;7;0
"782";"Sal5";"Ohasta";"199731H-QOhasta";"17.08.97";51;0;51;5;46;0,098039216
"783";"Sal14";"Olappo";"199731K1-32FOlappo";"16.08.97";91;10;81;14;67;0,172839506
"784";"Sal23";"Oretic";"199731S-XOretic";"17.08.97";22;2;20;3;17;0,15
"785";"Sal17";"Oglauc";"199732H-TOglauc";"17.08.97";75;10;65;37;28;0,569230769
"786";"Sal5";"Ohasta";"199732M1-33HOhasta";"16.08.97";71;15;56;18;38;0,321428571
"787";"Sal14";"Olappo";"199732V-K1Olappo";"16.08.97";93;36;57;3;54;0,052631579
"788";"Sal14";"Osamol";"199733J-V1Osamol";"01.08.97";192;18;174;151;23;0,867816092
"789";"Sal12";"Oproxi";"199734A-O1Oproxi";"21.09.97";206;38;168;156;12;0,928571429
"790";"Sal18";"Evenus";"199734Q1-35HEvenus";"15.09.97";75;0;75;21;54;0,28
"791";"Sal25";"Evenus";"199735J-36CEvenus";"15.09.97";329;14;315;41;274;0,13015873
"792";"Sal10";"Ovimin";"199736H1-V1Ovimin";"21.09.97";76;15;61;29;32;0,475409836
"793";"Sal10";"Ovimin";"199742A1-T1Ovimin";"27.09.97";96;3;93;28;65;0,301075269
"794";"Sal10";"Ovimin";"199742A-VOvimin";"27.09.97";109;2;107;43;64;0,401869159
"795";"Sal10";"Ovimin";"199743A-ZOvimin";"27.09.97";132;2;130;2;128;0,015384615
"796";"Sal16";"Ephyli";"1997SZ01Ephyli";"05.08.97";35;0;35;12;23;0,342857143
"797";"Sal16";"Ephyli";"1997SZ02Ephyli";"06.08.97";42;0;42;10;32;0,238095238
"798";"Sal14";"Elappo";"1997SZ03Elappo";"06.08.97";91;0;91;38;53;0,417582418
"799";"Sal27";"Elanat";"1997SZ04Elanat";"06.08.97";72;0;72;21;51;0,291666667
"800";"Sal17";"Eboreo";"1997SZ05Eboreo";"06.08.97";59;0;59;32;27;0,542372881
"801";"Sal5";"Ehasta";"1997SZ06Ehasta";"06.08.97";33;0;33;16;17;0,484848485
"802";"Sal30";"Emyrti";"1997SZ07Emyrti";"07.08.97";19;4;15;14;1;0,933333333
"803";"Sal30";"Emyrti";"1997SZ08Emyrti";"07.08.97";38;9;29;21;8;0,724137931
"804";"Sal30";"Esmyrt";"1997SZ09Esmyrt";"07.08.97";16;0;16;15;1;0,9375
"805";"Sal30";"Esmyrt";"1997SZ10Esmyrt";"07.08.97";11;0;11;8;3;0,727272727
"806";"Sal14";"Elappo";"1997SZ11Elappo";"07.08.97";69;1;68;46;22;0,676470588
"807";"Sal14";"Elappo";"1997SZ12Elappo";"07.08.97";37;0;37;23;14;0,621621622
"808";"Sal30";"Esmyrt";"1997SZ13Esmyrt";"08.08.97";21;0;21;15;6;0,714285714
"809";"Sal15";"Esmyrs";"1997SZ14Esmyrs";"08.08.97";6;0;6;3;3;0,5
"810";"Sal30";"Emyrti";"1997SZ15Emyrti";"08.08.97";5;2;3;3;0;1
"811";"Sal5";"Ehasta";"1997SZ16Ehasta";"09.08.97";151;0;151;87;64;0,57615894
"812";"Sal17";"Eboreo";"1997SZ17Eboreo";"09.08.97";153;5;148;79;69;0,533783784
"813";"Sal5";"Ehasta";"1997SZ18Ehasta";"10.08.97";52;0;52;33;19;0,634615385
"814";"Sal27";"Elanat";"1997SZ19Elanat";"10.08.97";33;0;33;20;13;0,606060606
"815";"Sal17";"Eboreo";"1997SZ20Eboreo";"10.08.97";31;0;31;23;8;0,741935484
"816";"Sal14";"Elappc";"1997SZ21Elappc";"10.08.97";8;0;8;7;1;0,875
"817";"Sal14";"Elappo";"1997SZ22Elappo";"10.08.97";153;0;153;102;51;0,666666667
"818";"Sal16";"Ephyli";"1997SZ23Ephyli";"10.08.97";133;0;133;0;133;0
"819";"Sal16";"Ephyli";"1997SZ24Ephyli";"13.08.97";15;0;15;3;12;0,2
"820";"Sal15";"Esmyrs";"1997SZ25Esmyrs";"13.08.97";51;0;51;45;6;0,882352941
"821";"Sal15";"Esmyrs";"1997SZ26Esmyrs";"13.08.97";51;0;51;49;2;0,960784314
"822";"Sal5";"Ehasta";"1997SZ27Ehasta";"13.08.97";116;0;116;71;45;0,612068966
"823";"Sal3";"Emyrsi";"1997SZ28Emyrsi";"13.08.97";26;0;26;21;5;0,807692308
"824";"Sal5";"Ehasta";"1997SZ29Ehasta";"12.08.97";28;0;28;23;5;0,821428571
"825";"Sal3";"Emyrsi";"1997SZ30Emyrsi";"12.08.97";64;0;64;56;8;0,875
"826";"Sal27";"Elanat";"1997SZ31Elanat";"12.08.97";98;0;98;54;44;0,551020408
"827";"Sal14";"Elappo";"1997SZ32Elappo";"14.08.97";62;0;62;59;3;0,951612903
"828";"Sal18";"Enigri";"1997SZ34Enigri";"14.08.97";35;0;35;31;4;0,885714286
"829";"Sal5";"Ehasta";"1997SZ35Ehasta";"16.08.97";34;0;34;25;9;0,735294118
"830";"Sal27";"Elanat";"1997SZ36Elanat";"16.08.97";63;0;63;0;63;0
"831";"Sal14";"Elappo";"1997SZ37Elappo";"16.08.97";34;0;34;29;5;0,852941176
"832";"Sal17";"Eboreo";"1997SZ38Eboreo";"16.08.97";41;0;41;36;5;0,87804878
"833";"Sal14";"Elappc";"1997SZ39Elappc";"16.08.97";51;3;48;44;4;0,916666667
"834";"Sal17";"Eboreo";"1997SZ41Eboreo";"17.08.97";38;0;38;30;8;0,789473684
"835";"Sal3";"Emyrsi";"1997SZ42Emyrsi";"17.08.97";10;0;10;8;2;0,8
"836";"Sal14";"Elappc";"1997SZ43Elappc";"17.08.97";15;0;15;14;1;0,933333333
"837";"Sal25";"Emucro";"1997SZ44Emucro";"18.08.97";19;0;19;19;0;1
"838";"Sal25";"Emucro";"1997SZ45Emucro";"18.08.97";25;0;25;20;5;0,8
"839";"Sal25";"Eaurit";"1997SZ46Eaurit";"18.08.97";31;0;31;27;4;0,870967742
"840";"Sal25";"Emucro";"1997SZ47Emucro";"19.08.97";14;0;14;6;8;0,428571429
"841";"Sal25";"Eaurit";"1997SZ48Eaurit";"19.08.97";9;0;9;9;0;1
"842";"Sal25";"Eaurit";"1997SZ49Eaurit";"19.08.97";88;0;88;51;37;0,579545455
"843";"Sal25";"Eaurit";"1997SZ50Eaurit";"20.08.97";26;1;25;23;2;0,92
"844";"Sal14";"Elappo";"1997SZ51Elappo";"22.08.97";16;0;16;13;3;0,8125
"845";"Sal14";"Elappc";"1997SZ52Elappc";"22.08.97";39;0;39;31;8;0,794871795
"846";"Sal17";"Eboreo";"1997SZ53Eboreo";"22.08.97";28;0;28;19;9;0,678571429
"847";"Sal3";"Emyrsi";"1997SZ54Emyrsi";"23.08.97";45;11;34;29;5;0,852941176
"848";"Sal14";"Elappo";"1997SZ55Elappo";"23.08.97";20;0;20;13;7;0,65
"849";"Sal14";"Elappc";"1997SZ56Elappc";"24.08.97";11;0;11;9;2;0,818181818
"850";"Sal9";"Eciner";"1997SZ57Eciner";"24.08.97";52;0;52;44;8;0,846153846
"851";"Sal25";"Emucro";"1997SZ58Emucro";"24.08.97";41;0;41;25;16;0,609756098
"852";"Sal17";"Eboreo";"1997SZ59Eboreo";"24.08.97";16;0;16;9;7;0,5625
"853";"Sal9";"Egemmc";"1997SZ60Egemmc";"24.08.97";27;0;27;4;23;0,148148148
"854";"Sal13";"Eweiff";"1997SZ61Eweiff";"29.08.97";33;0;33;10;23;0,303030303
"855";"Sal5";"Ehasta";"1997SZ62Ehasta";"11.08.97";68;0;68;32;36;0,470588235
"856";"Sal18";"Hleuco";"1997SZ63Hleuco";"14.08.97";3;0;3;0;3;0
"857";"Sal17";"Hplicg";"1997SZ64Hplicg";"08.08.97";108;33;75;3;72;0,04
"858";"Sal17";"Hplicg";"1997SZ65Hplicg";"22.08.97";46;14;32;7;25;0,21875
"859";"Sal25";"Halien";"1997SZ66Halien";"18.08.97";59;26;33;0;33;0
"860";"Sal18";"Hleuco";"1997SZ68Hleuco";"03.08.97";4;0;4;0;4;0
"861";"Sal17";"Hplicg";"1997SZ69Hplicg";"17.08.97";22;0;22;0;22;0
"862";"Sal3";"Hischn";"1997SZ70Hischn";"17.08.97";9;0;9;0;9;0
"863";"Sal11";"Hoblit";"1997SZ71Hoblit";"09.07.97";155;16;139;8;131;0,057553957
"864";"Sal10";"Hpolit";"1997SZ72Hpolit";"09.07.97";89;39;50;8;42;0,16
"865";"Sal9";"Hpruss";"1997SZ73Hpruss";"09.07.97";64;26;38;0;38;0
"866";"Sal31";"Hangli";"1997SZ74Hangli";"09.07.97";143;21;122;3;119;0,024590164
"867";"Sal25";"Heryth";"1997SZ75Heryth";"13.07.97";201;83;118;3;115;0,025423729
"868";"Sal25";"Halien";"1997SZ76Halien";"13.07.97";74;32;42;3;39;0,071428571
"869";"Sal14";"Hacuti";"1997SZ77Hacuti";"16.08.97";237;63;174;0;174;0
"870";"Sal21";"Hcarin";"1997SZ78Hcarin";"19.08.97";17;0;17;0;17;0
"871";"Sal25";"Emucro";"1997SZ79Emucro";"21.09.97";73;15;58;28;30;0,482758621
"872";"Sal25";"Eaurit";"1997SZ80Eaurit";"15.09.97";6;0;6;0;6;0
"873";"Sal25";"Emucro";"1997SZ81Emucro";"15.09.97";35;0;35;0;35;0
"874";"Sal9";"Eciner";"1997SZ83aEciner";"14.10.97";3;0;3;2;1;0,666666667
"875";"Sal9";"Egemmc";"1997SZ83Egemmc";"14.10.97";29;1;28;10;18;0,357142857
"876";"Sal25";"Eaurit";"1997SZ84Eaurit";"01.10.97";30;0;30;7;23;0,233333333
"877";"Sal35";"Eweiff";"1997SZ85Eweiff";"09.03.98";123;0;123;77;46;0,62601626
"878";"Sal12";"Eatraa";"1997SZ86Eatraa";"13.04.98";7;0;7;0;7;0
"879";"Sal13";"Ocolla";"199801A-V1Ocolla";"13.08.98";295;1;294;93;201;0,316326531
"880";"Sal1";"Okriec";"199802A-P1Okriec";"23.08.98";254;15;239;179;60;0,748953975
"881";"Sal20";"Ofoeti";"199802R1-V1Ofoeti";"23.08.98";22;0;22;13;9;0,590909091
"882";"Sal35";"Ocolla";"199803A-KOcolla";"25.08.98";64;0;64;20;44;0,3125
"883";"Sal3";"Ovaria";"199803B1-V1Ovaria";"24.08.98";124;0;124;36;88;0,290322581
"884";"Sal19";"Ovaria";"199803M-ZOvaria";"22.08.98";86;4;82;34;48;0,414634146
"885";"Sal18";"Ogalla";"199804A-IOgalla";"23.08.98";54;2;52;22;30;0,423076923
"886";"Sal5";"Ohasta";"199804K-ZOhasta";"29.08.98";96;2;94;32;62;0,340425532
"887";"Sal25";"Obella";"199806A1-H1Obella";"25.08.98";41;10;31;11;20;0,35483871
"888";"Sal2";"Obridg";"199806A-GObridg";"23.08.98";33;5;28;18;10;0,642857143
"889";"Sal2";"Obridg";"199806I-YObridg";"23.08.98";88;3;85;50;35;0,588235294
"890";"Sal25";"Obella";"199806J1-R1Obella";"25.08.98";51;2;49;19;30;0,387755102
"891";"Sal18";"Obridg";"199806U1-V1Obridg";"23.08.98";7;0;7;5;2;0,714285714
"892";"Sal12";"Etesta";"199807A-BEtesta";"26.08.98";9;0;9;4;5;0,444444444
"893";"Sal20";"Oobscu";"199807B1-L1Oobscu";"24.08.98";55;2;53;19;34;0,358490566
"894";"Sal25";"Evenus";"199807D-ZEvenus";"25.08.98";141;6;135;63;72;0,466666667
"895";"Sal11";"Etesta";"199807N1-Q1Etesta";"24.08.98";18;2;16;11;5;0,6875
"896";"Sal10";"Hpolit";"1998SZ01Hpolit";"12.07.98";123;39;84;14;70;0,166666667
"897";"Sal31";"Hangli";"1998SZ02Hangli";"12.07.98";250;8;242;5;237;0,020661157
"898";"Sal25";"Heryth";"1998SZ03aHeryth";"19.07.98";232;91;141;14;127;0,09929078
"899";"Sal25";"Heryth";"1998SZ03bHeryth";"02.08.98";131;44;87;5;82;0,057471264
"900";"Sal31";"Hangli";"1998SZ04Hangli";"19.07.98";242;2;240;1;239;0,004166667
"901";"Sal12";"Eatraa";"1998SZ05Eatraa";"27.08.98";50;0;50;0;50;0
"902";"Sal12";"Eatraa";"1998SZ06Eatraa";"26.08.98";65;13;52;43;9;0,826923077
"903";"Sal10";"Epurpu";"1998SZ07Epurpu";"23.08.98";49;17;32;14;18;0,4375
"904";"Sal1";"Eelaea";"1998SZ08Eelaea";"24.08.98";60;4;56;28;28;0,5
"905";"Sal19";"Emyrsi";"1998SZ09Emyrsi";"22.08.98";97;0;97;43;54;0,443298969
"906";"Sal7";"Omacul";"1998SZ10Omacul";"28.08.98";39;0;39;0;39;0
"907";"Sal2";"Eappen";"1998SZ11Eappen";"22.08.98";160;0;160;20;140;0,125
"908";"Sal6";"Edaphn";"1998SZ12Edaphn";"22.08.98";10;0;10;4;6;0,4
"909";"Sal19";"Emyrsi";"1998SZ13Emyrsi";"22.08.98";117;0;117;28;89;0,239316239
"910";"Sal2";"Eappen";"1998SZ14Eappen";"22.08.98";92;0;92;51;41;0,554347826
"911";"Sal20";"Egemmf";"1998SZ15Egemmf";"22.08.98";30;0;30;5;25;0,166666667
"912";"Sal19";"Hischn";"1998SZ16Hischn";"01.08.98";258;26;232;11;221;0,047413793
"913";"Sal5";"Ehasta";"1998SZ17Ehasta";"28.08.98";11;0;11;8;3;0,727272727
"914";"Sal2";"Eappen";"1998SZ18Eappen";"22.08.98";10;0;10;5;5;0,5
"915";"Sal5";"Ehasta";"1998SZ19Ehasta";"22.08.98";56;0;56;26;30;0,464285714
"916";"Sal7";"Egemmh";"1998SZ20Egemmh";"28.08.98";29;0;29;16;13;0,551724138
"917";"Sal7";"Egemmh";"1998SZ21Egemmh";"29.08.98";135;0;135;35;100;0,259259259
"918";"Sal25";"Emucro";"1998SZ22Emucro";"25.08.98";25;0;25;6;19;0,24
"919";"Sal25";"Emucro";"1998SZ23Emucro";"26.08.98";109;0;109;38;71;0,348623853
"920";"Sal1";"Eelaea";"1998SZ24Eelaea";"22.08.98";104;1;103;9;94;0,087378641
"921";"Sal5";"Ehasta";"1998SZ25Ehasta";"29.08.98";12;0;12;2;10;0,166666667
"922";"Sal10";"Hpolit";"1998SZ26Hpolit";"23.08.98";292;50;242;14;228;0,05785124
"923";"Sal6";"Hplicd";"1998SZ27Hplicd";"22.08.98";502;92;410;6;404;0,014634146
"924";"Sal21";"Hcarin";"1998SZ28Hcarin";"28.08.98";289;163;126;19;107;0,150793651
"925";"Sal34";"Hoblit";"1998SZ29Hoblit";"27.08.98";12;1;11;1;10;0,090909091
"926";"Sal25";"Heryth";"1998SZ30Heryth";"25.08.98";66;8;58;1;57;0,017241379
"927";"Sal8";"Hplicg";"1998SZ31Hplicg";"29.08.98";62;4;58;8;50;0,137931034
"928";"Sal7";"Hspirh";"1998SZ32Hspirh";"29.08.98";14;2;12;1;11;0,083333333
"929";"Sal25";"Eaurit";"1998SZ33Eaurit";"07.03.99";70;3;67;38;29;0,567164179
"930";"Sal25";"Emucro";"1998SZ34Emucro";"07.03.99";27;0;27;8;19;0,296296296
"931";"Sal25";"Eaurit";"1998SZ35Eaurit";"07.03.99";39;2;37;14;23;0,378378378
"932";"Sal25";"Emucro";"1998SZ36Emucro";"07.03.99";10;0;10;3;7;0,3
"933";"Sal25";"Eaurit";"1998SZ37Eaurit";"07.03.99";22;2;20;13;7;0,65
"934";"Sal25";"Emucro";"1998SZ38Emucro";"07.03.99";24;0;24;7;17;0,291666667
"935";"Sal12";"Eatraa";"1998SZ39Eatraa";"09.04.99";59;9;50;26;24;0,52
"936";"Sal10";"Ovimin";"199901G-WOvimin";"06.07.99";68;0;68;28;40;0,411764706
"937";"Sal10";"Ovesic";"199901Y-V1Ovesic";"06.07.99";124;0;124;107;17;0,862903226
"938";"Sal11";"Oproxi";"199902A-MOproxi";"28.06.99";52;0;52;14;38;0,269230769
"939";"Sal34";"Oproxi";"199902N-O1Oproxi";"29.06.99";43;0;43;39;4;0,906976744
"940";"Sal1";"Okriec";"199903A-S/A1-V1Okriec";"19.07.99";199;0;199;120;79;0,603015075
"941";"Sal10";"Ovimin";"199903U-Z/10A-V1Ovimin";"19.07.99";266;0;266;176;90;0,661654135
"942";"Sal10";"Ovimin";"199913A-COvimin";"05.07.99";13;0;13;10;3;0,769230769
"943";"Sal10";"Ovimin";"199913C1-D1Ovimin";"06.07.99";6;0;6;4;2;0,666666667
"944";"Sal11";"Oproxi";"199913E-I/U-WOproxi";"05.07.99";64;0;64;49;15;0,765625
"945";"Sal3";"Ovaria";"199913K-TOvaria";"06.07.99";49;0;49;14;35;0,285714286
"946";"Sal1";"Okriec";"199914A1-V1Okriec";"19.07.99";133;0;133;64;69;0,481203008
"947";"Sal10";"Ovimin";"199914A-BOvimin";"06.07.99";7;0;7;3;4;0,428571429
"948";"Sal10";"Ovimin";"199914D-IOvimin";"05.07.99";24;0;24;13;11;0,541666667
"949";"Sal1";"Okriec";"199914K-WOkriec";"19.07.99";63;0;63;30;33;0,476190476
"950";"Sal10";"Ovesic";"199914X-ZOvesic";"19.07.99";14;0;14;3;11;0,214285714
"951";"Sal19";"Onigri";"199915A-16NOnigri";"29.07.99";239;0;239;231;8;0,966527197
"952";"Sal1";"Okriec";"199923A1-F1Okriec";"21.07.99";30;0;30;19;11;0,633333333
"953";"Sal10";"Ovimin";"199923A-GOvimin";"20.07.99";37;0;37;22;15;0,594594595
"954";"Sal10";"Ovimin";"199923G1-S1Ovimin";"20.07.99";55;0;55;42;13;0,763636364
"955";"Sal1";"Okriec";"199923H-POkriec";"20.07.99";44;0;44;21;23;0,477272727
"956";"Sal10";"Ovimin";"199923Q-ZOvimin";"20.07.99";55;0;55;48;7;0,872727273
"957";"Sal1";"Okriec";"199924A-25SOkriec";"20.07.99";379;0;379;249;130;0,656992084
"958";"Sal10";"Ovesic";"199925A1-E1Ovesic";"20.07.99";11;0;11;1;10;0,090909091
"959";"Sal36";"Evenus";"199925G1-L1Evenus";"18.07.99";17;0;17;14;3;0,823529412
"960";"Sal10";"Ovimin";"199925T-YOvimin";"20.07.99";29;0;29;21;8;0,724137931
"961";"Sal1";"Okriec";"199926A-27NOkriec";"30.08.99";296;0;296;139;157;0,469594595
"962";"Sal22";"Obrevi";"199927O1-28GObrevi";"01.09.99";52;0;52;31;21;0,596153846
"963";"Sal10";"Ovimin";"199927P-WOvimin";"30.08.99";42;0;42;39;3;0,928571429
"964";"Sal10";"Ovesic";"199927Y-M1Ovesic";"31.08.99";89;0;89;15;74;0,168539326
"965";"Sal3";"Ovaria";"199928I-30ZOvaria";"01.09.99";492;0;492;187;305;0,380081301
"966";"Sal4";"Ofoeti";"199930A1-Q1Ofoeti";"01.09.99";77;0;77;48;29;0,623376623
"967";"Sal4";"Oobscu";"199930R1-31AOobscu";"01.09.99";43;0;43;33;10;0,76744186
"968";"Sal4";"Ofoeti";"199931C-I1Ofoeti";"01.09.99";157;0;157;81;76;0,515923567
"969";"Sal4";"Oobscu";"199931K1-N1Oobscu";"01.09.99";20;0;20;12;8;0,6
"970";"Sal22";"Obrevi";"199932A-J1Obrevi";"01.09.99";182;0;182;149;33;0,818681319
"971";"Sal2";"Obridg";"199932L1-N1Obridg";"02.09.99";17;0;17;9;8;0,529411765
"972";"Sal3";"Ovaria";"199932P1-33ROvaria";"02.09.99";127;0;127;93;34;0,732283465
"973";"Sal4";"Ofoeti";"199933D1-N1Ofoeti";"02.09.99";43;0;43;6;37;0,139534884
"974";"Sal4";"Ofoeti";"199933P1-U1Ofoeti";"02.09.99";21;0;21;5;16;0,238095238
"975";"Sal22";"Obrevi";"199933T-B1Obrevi";"02.09.99";45;0;45;30;15;0,666666667
"976";"Sal4";"Oobscu";"199934A-BOobscu";"02.09.99";12;0;12;8;4;0,666666667
"977";"Sal4";"Ofoeti";"199934D-SOfoeti";"03.09.99";56;0;56;14;42;0,25
"978";"Sal4";"Oobscu";"199934U-35IOobscu";"03.09.99";202;0;202;131;71;0,648514851
"979";"Sal24";"Oretus";"199935A1-V1Oretus";"03.09.99";93;0;93;61;32;0,655913978
"980";"Sal22";"Obrevi";"199935K-YObrevi";"03.09.99";69;0;69;18;51;0,260869565
"981";"Sal4";"Ofoeti";"199936A-GOfoeti";"03.09.99";33;0;33;17;16;0,515151515
"982";"Sal22";"Obrevi";"199936I-PObrevi";"03.09.99";40;0;40;6;34;0,15
"983";"Sal4";"Ofoeti";"199936R-TOfoeti";"03.09.99";16;0;16;2;14;0,125
"984";"Sal37";"Opedun";"199936T1-V1Opedun";"25.08.99";25;0;25;12;13;0,48
"985";"Sal4";"Oobscu";"199936V-S1Oobscu";"03.09.99";133;0;133;39;94;0,293233083
"986";"Sal23";"Oretic";"199937A-V1Oretic";"03.09.99";151;0;151;53;98;0,350993377
"987";"Sal4";"Egemmf";"199938A1-D1Egemmf";"01.09.99";20;0;20;15;5;0,75
"988";"Sal4";"Egemmf";"199938A-JEgemmf";"03.09.99";44;0;44;19;25;0,431818182
"989";"Sal4";"Egemmf";"199938F1-M1Egemmf";"01.09.99";38;0;38;32;6;0,842105263
"990";"Sal4";"Egemmf";"199938L-M1Egemmf";"01.09.99";109;0;109;34;75;0,311926606
"991";"Sal6";"Edaphn";"199938O1-T1Edaphn";"31.08.99";27;0;27;18;9;0,666666667
"992";"Sal18";"Enigri";"199942A-HEnigri";"30.08.99";46;4;42;27;15;0,642857143
"993";"Sal18";"Enigri";"199942F-HEnigri";"30.08.99";37;2;35;24;11;0,685714286
"994";"Sal11";"Oproxi";"199943A-V1Oproxi";"13.09.99";268;0;268;223;45;0,832089552
"995";"Sal34";"Oproxi";"199944A-V1Oproxi";"14.09.99";259;4;255;169;86;0,662745098
"996";"Sal34";"Oproxi";"199945A-F1Oproxi";"13.09.99";164;22;142;47;95;0,330985915
"997";"Sal34";"Oproxi";"199945G1-46OOproxi";"14.09.99";178;0;178;147;31;0,825842697
"998";"Sal26";"Otrian";"199946Q-ROtrian";"14.09.99";10;0;10;3;7;0,3
"999";"Sal11";"Oproxi";"199946T-XOproxi";"13.09.99";31;0;31;29;2;0,935483871
"1000";"Sal11";"Oproxi";"199948A-F1Oproxi";"28.09.99";167;5;162;33;129;0,203703704
"1001";"Sal31";"Hangli";"1999SZ04Hangli";"30.06.99";5;1;4;0;4;0
"1002";"Sal11";"Hoblit";"1999SZ05Hoblit";"28.06.99";27;11;16;0;16;0
"1003";"Sal38";"Hangli";"1999SZ06Hangli";"29.06.99";19;1;18;0;18;0
"1004";"Sal34";"Hoblit";"1999SZ07Hoblit";"29.06.99";4;0;4;0;4;0
"1005";"Sal31";"Hangli";"1999SZ08Hangli";"01.07.99";184;5;179;3;176;0,016759777
"1006";"Sal34";"Hoblit";"1999SZ09Hoblit";"29.06.99";1;0;1;0;1;0
"1007";"Sal34";"Hoblit";"1999SZ10Hoblit";"29.06.99";4;0;4;0;4;0
"1008";"Sal12";"Hoblit";"1999SZ11aHoblit";"28.06.99";12;3;9;0;9;0
"1009";"Sal34";"Hoblit";"1999SZ11Hoblit";"28.06.99";11;5;6;0;6;0
"1010";"Sal11";"Hoblit";"1999SZ12Hoblit";"28.06.99";8;2;6;0;6;0
"1011";"Sal12";"Hoblit";"1999SZ13Hoblit";"28.06.99";5;1;4;1;3;0,25
"1012";"Sal34";"Hoblit";"1999SZ14Hoblit";"29.06.99";3;0;3;0;3;0
"1013";"Sal12";"Hoblit";"1999SZ15Hoblit";"28.06.99";6;2;4;0;4;0
"1014";"Sal34";"Hoblit";"1999SZ16Hoblit";"29.06.99";7;0;7;1;6;0,142857143
"1015";"Sal31";"Hangli";"1999SZ17Hangli";"01.07.99";30;3;27;0;27;0
"1016";"Sal31";"Hangli";"1999SZ18Hangli";"01.07.99";62;4;58;1;57;0,017241379
"1017";"Sal31";"Hangli";"1999SZ19Hangli";"30.06.99";17;3;14;0;14;0
"1018";"Sal31";"Hangli";"1999SZ20Hangli";"30.06.99";37;6;31;1;30;0,032258065
"1019";"Sal31";"Hangli";"1999SZ21Hangli";"30.06.99";24;1;23;0;23;0
"1020";"Sal31";"Hangli";"1999SZ22Hangli";"29.06.99";12;2;10;0;10;0
"1021";"Sal31";"Hangli";"1999SZ23Hangli";"01.07.99";79;3;76;4;72;0,052631579
"1022";"Sal31";"Hangli";"1999SZ24Hangli";"30.06.99";21;12;9;0;9;0
"1023";"Sal31";"Hangli";"1999SZ25Hangli";"30.06.99";14;0;14;0;14;0
"1024";"Sal31";"Hangli";"1999SZ26Hangli";"30.06.99";8;1;7;0;7;0
"1025";"Sal31";"Hangli";"1999SZ27Hangli";"30.06.99";3;0;3;0;3;0
"1026";"Sal31";"Hangli";"1999SZ28Hangli";"08.07.99";43;39;4;0;4;0
"1027";"Sal31";"Hangli";"1999SZ29Hangli";"08.07.99";11;3;8;0;8;0
"1028";"Sal10";"Hpolit";"1999SZ30Hpolit";"05.07.99";25;5;20;0;20;0
"1029";"Sal31";"Hangli";"1999SZ31Hangli";"08.07.99";20;14;6;0;6;0
"1030";"Sal39";"Hangli";"1999SZ32Hangli";"08.07.99";16;9;7;0;7;0
"1031";"Sal31";"Hangli";"1999SZ33Hangli";"08.07.99";2;1;1;0;1;0
"1032";"Sal11";"Hoblit";"1999SZ34Hoblit";"05.07.99";5;0;5;0;5;0
"1033";"Sal11";"Hoblit";"1999SZ35Hoblit";"05.07.99";22;2;20;0;20;0
"1034";"Sal11";"Hoblit";"1999SZ36Hoblit";"08.07.99";8;2;6;2;4;0,333333333
"1035";"Sal10";"Hpolit";"1999SZ37Hpolit";"06.07.99";17;7;10;0;10;0
"1036";"Sal11";"Hoblit";"1999SZ38Hoblit";"06.07.99";11;2;9;0;9;0
"1037";"Sal10";"Hpolit";"1999SZ39Hpolit";"06.07.99";60;9;51;7;44;0,137254902
"1038";"Sal35";"Eweiff";"1999SZ40Eweiff";"03.04.99";89;0;89;74;15;0,831460674
"1039";"Sal31";"Hangli";"1999SZ40Hangli";"08.07.99";12;8;4;0;4;0
"1040";"Sal10";"Hpolit";"1999SZ42Hpolit";"05.07.99";18;5;13;0;13;0
"1041";"Sal10";"Hpolit";"1999SZ43Hpolit";"05.07.99";4;1;3;2;1;0,666666667
"1042";"Sal11";"Hoblit";"1999SZ44Hoblit";"06.07.99";6;2;4;0;4;0
"1043";"Sal31";"Hangli";"1999SZ45Hangli";"06.07.99";42;22;20;0;20;0
"1044";"Sal9";"Hpruss";"1999SZ46Hpruss";"06.07.99";49;12;37;2;35;0,054054054
"1045";"Sal10";"Hpolit";"1999SZ47Hpolit";"05.07.99";57;7;50;0;50;0
"1046";"Sal11";"Hoblit";"1999SZ48Hoblit";"05.07.99";40;8;32;0;32;0
"1047";"Sal10";"Hpolit";"1999SZ49Hpolit";"06.07.99";31;2;29;2;27;0,068965517
"1048";"Sal11";"Hoblit";"1999SZ50Hoblit";"06.07.99";29;10;19;0;19;0
"1049";"Sal11";"Hoblit";"1999SZ51Hoblit";"06.07.99";14;5;9;0;9;0
"1050";"Sal9";"Hpruss";"1999SZ52Hpruss";"06.07.99";58;28;30;1;29;0,033333333
"1051";"Sal9";"Hpruss";"1999SZ53Hpruss";"06.07.99";48;24;24;2;22;0,083333333
"1052";"Sal11";"Hoblit";"1999SZ54Hoblit";"06.07.99";5;2;3;0;3;0
"1053";"Sal3";"Hischn";"1999SZ55Hischn";"14.07.99";27;15;12;1;11;0,083333333
"1054";"Sal3";"Hischn";"1999SZ56Hischn";"20.07.99";18;2;16;0;16;0
"1055";"Sal3";"Hischn";"1999SZ97Hischn";"01.09.99";55;1;54;0;54;0
"1056";"Sal1";"Eelaea";"1999T1Eelaea";"02.06.99";3;0;3;1;2;0,333333333
"1057";"Sal1";"Eelaea";"1999U1Eelaea";"02.06.99";1;0;1;0;1;0
"1058";"Sal1";"Eelaea";"1999W1Eelaea";"02.06.99";3;0;3;0;3;0
"1059";"Sal1";"Eelaea";"1999V2Eelaea";"02.06.99";2;0;2;0;2;0
"1060";"Sal1";"Eelaea";"1999X1Eelaea";"02.06.99";1;0;1;0;1;0
"1061";"Sal1";"Eelaea";"1999Y1Eelaea";"02.06.99";5;0;5;0;5;0
"1062";"Sal1";"Eelaea";"1999Z1Eelaea";"27.05.99";2;0;2;0;2;0
"1063";"Sal18";"Enigri";"200014A-NEnigri";"14.08.00";56;0;56;32;24;0,571428571
"1064";"Sal18";"Enigri";"200014P-V1Enigri";"14.08.00";116;0;116;58;58;0,5
"1065";"Sal11";"Oproxi";"200023A-OOproxi";"17.07.00";92;0;92;52;40;0,565217391
"1066";"Sal11";"Oproxi";"200023D1-O1Oproxi";"17.07.00";76;0;76;14;62;0,184210526
"1067";"Sal11";"Oproxi";"200023Q1-24LOproxi";"17.07.00";107;0;107;29;78;0,271028037
"1068";"Sal11";"Oproxi";"200023Q-B1Oproxi";"17.07.00";74;0;74;33;41;0,445945946
"1069";"Sal10";"Ovimin";"200024A1-V1Ovimin";"17.07.00";99;1;98;38;60;0,387755102
"1070";"Sal10";"Ovimin";"200024N-OOvimin";"17.07.00";8;0;8;1;7;0,125
"1071";"Sal10";"Ovesic";"200024QOvesic";"17.07.00";4;0;4;0;4;0
"1072";"Sal10";"Ovimin";"200024S-TOvimin";"17.07.00";7;0;7;2;5;0,285714286
"1073";"Sal10";"Ovesic";"200024V-WOvesic";"17.07.00";7;0;7;0;7;0
"1074";"Sal10";"Ovimin";"200025A1-C1Ovimin";"20.07.00";13;0;13;4;9;0,307692308
"1075";"Sal10";"Ovimin";"200025A-DOvimin";"19.07.00";16;0;16;6;10;0,375
"1076";"Sal10";"Ovimin";"200025E1-F1Ovimin";"20.07.00";9;0;9;8;1;0,888888889
"1077";"Sal11";"Oproxi";"200025F-JOproxi";"19.07.00";32;0;32;8;24;0,25
"1078";"Sal3";"Ovaria";"200025L-UOvaria";"19.07.00";42;0;42;11;31;0,261904762
"1079";"Sal11";"Etesta";"200025M1-V1Etesta";"12.07.00";55;3;52;29;23;0,557692308
"1080";"Sal1";"Okriec";"200026A1-F1Okriec";"24.07.00";29;0;29;22;7;0,75862069
"1081";"Sal10";"Ovimin";"200026A-MOvimin";"24.07.00";51;0;51;35;16;0,68627451
"1082";"Sal1";"Okriec";"200026H1-27GOkriec";"24.07.00";94;6;88;59;29;0,670454545
"1083";"Sal10";"Ovimin";"200026O-ZOvimin";"24.07.00";49;3;46;34;12;0,739130435
"1084";"Sal1";"Okriec";"200027A1-O1Okriec";"24.07.00";72;7;65;52;13;0,8
"1085";"Sal1";"Okriec";"200027J-XOkriec";"24.07.00";67;4;63;44;19;0,698412698
"1086";"Sal4";"Oobscu";"200027Q1-S1Oobscu";"25.07.00";21;0;21;8;13;0,380952381
"1087";"Sal4";"Oobscu";"200027U1-V1Oobscu";"25.07.00";8;0;8;1;7;0,125
"1088";"Sal10";"Ovimin";"200028A1-P1Ovimin";"26.07.00";67;0;67;38;29;0,567164179
"1089";"Sal4";"Oobscu";"200028A-DOobscu";"25.07.00";23;0;23;11;12;0,47826087
"1090";"Sal4";"Oobscu";"200028F-OOobscu";"25.07.00";60;0;60;16;44;0,266666667
"1091";"Sal4";"Oobscu";"200028Q-VOobscu";"25.07.00";38;0;38;9;29;0,236842105
"1092";"Sal10";"Ovimin";"200028R1-29EOvimin";"26.07.00";39;0;39;27;12;0,692307692
"1093";"Sal4";"Oobscu";"200028XOobscu";"25.07.00";10;6;4;3;1;0,75
"1094";"Sal1";"Okriec";"200029A1-P1Okriec";"26.07.00";65;3;62;37;25;0,596774194
"1095";"Sal1";"Okriec";"200029G-VOkriec";"26.07.00";67;1;66;39;27;0,590909091
"1096";"Sal1";"Okriec";"200029R1-30LOkriec";"26.07.00";73;4;69;45;24;0,652173913
"1097";"Sal2";"Obridg";"200030A1-T1Obridg";"26.07.00";123;8;115;37;78;0,32173913
"1098";"Sal2";"Obridg";"200030N-YObridg";"26.07.00";72;4;68;9;59;0,132352941
"1099";"Sal4";"Oobscu";"200031A-COobscu";"25.07.00";16;1;15;3;12;0,2
"1100";"Sal4";"Oobscu";"200031E-GOobscu";"25.07.00";17;1;16;5;11;0,3125
"1101";"Sal4";"Oobscu";"200031F1-G1Oobscu";"25.07.00";12;0;12;7;5;0,583333333
"1102";"Sal4";"Ofoeti";"200031I1-P1Ofoeti";"25.07.00";48;0;48;3;45;0,0625
"1103";"Sal4";"Ofoeti";"200031I-POfoeti";"25.07.00";48;0;48;16;32;0,333333333
"1104";"Sal4";"Ofoeti";"200031R1-U1Ofoeti";"25.07.00";24;1;23;3;20;0,130434783
"1105";"Sal4";"Ofoeti";"200031R-D1Ofoeti";"25.07.00";77;0;77;13;64;0,168831169
"1106";"Sal4";"Oobscu";"200032A-EOobscu";"25.07.00";31;0;31;6;25;0,193548387
"1107";"Sal4";"Oobscu";"200032G-LOobscu";"25.07.00";37;2;35;6;29;0,171428571
"1108";"Sal4";"Oobscu";"200032NOobscu";"25.07.00";6;0;6;3;3;0,5
"1109";"Sal4";"Oobscu";"200032P-TOobscu";"25.07.00";28;0;28;5;23;0,178571429
"1110";"Sal4";"Oobscu";"200032V-R1Oobscu";"25.07.00";136;4;132;22;110;0,166666667
"1111";"Sal4";"Oobscu";"200033A-UOobscu";"27.07.00";126;2;124;6;118;0,048387097
"1112";"Sal4";"Ofoeti";"200033E1-M1Ofoeti";"27.07.00";36;0;36;6;30;0,166666667
"1113";"Sal4";"Oobscu";"200033O1-U1Oobscu";"27.07.00";39;0;39;3;36;0,076923077
"1114";"Sal4";"Oobscu";"200033W-C1Oobscu";"27.07.00";40;0;40;8;32;0,2
"1115";"Sal4";"Oobscu";"200034A1-L1Oobscu";"27.07.00";70;1;69;10;59;0,144927536
"1116";"Sal4";"Oobscu";"200034A-GOobscu";"27.07.00";41;2;39;2;37;0,051282051
"1117";"Sal4";"Oobscu";"200034I-VOobscu";"27.07.00";84;9;75;17;58;0,226666667
"1118";"Sal4";"Oobscu";"200034N1-U1Oobscu";"27.07.00";48;1;47;4;43;0,085106383
"1119";"Sal4";"Oobscu";"200035A-JOobscu";"27.07.00";63;0;63;18;45;0,285714286
"1120";"Sal40";"Oobscu";"200035L-UOobscu";"27.07.00";61;1;60;4;56;0,066666667
"1121";"Sal22";"Obrevi";"200039A1-F1Obrevi";"16.08.00";22;0;22;3;19;0,136363636
"1122";"Sal24";"Oretus";"200039A-QOretus";"26.08.00";67;0;67;27;40;0,402985075
"1123";"Sal22";"Obrevi";"200039H1-R1Obrevi";"16.08.00";44;1;43;2;41;0,046511628
"1124";"Sal22";"Obrevi";"200039S-XObrevi";"16.08.00";22;0;22;10;12;0,454545455
"1125";"Sal22";"Obrevi";"200039T1-U1Obrevi";"16.08.00";10;0;10;0;10;0
"1126";"Sal4";"Ofoeti";"200040A-OOfoeti";"16.08.00";61;0;61;7;54;0,114754098
"1127";"Sal4";"Ofoeti";"200040M1-41OOfoeti";"16.08.00";100;0;100;13;87;0,13
"1128";"Sal4";"Ofoeti";"200040Q-K1Ofoeti";"16.08.00";84;0;84;4;80;0,047619048
"1129";"Sal4";"Ofoeti";"200041Q-Q1Ofoeti";"16.08.00";109;0;109;12;97;0,110091743
"1130";"Sal22";"Obrevi";"200041S1-V1Obrevi";"15.08.00";22;0;22;13;9;0,590909091
"1131";"Sal22";"Obrevi";"200042A-J1Obrevi";"15.08.00";145;0;145;22;123;0,151724138
"1132";"Sal22";"Obrevi";"200042L1-V1Obrevi";"15.08.00";62;0;62;9;53;0,14516129
"1133";"Sal22";"Obrevi";"200043A-GObrevi";"15.08.00";26;0;26;6;20;0,230769231
"1134";"Sal22";"Obrevi";"200043I-QObrevi";"15.08.00";36;1;35;7;28;0,2
"1135";"Sal3";"Ovaria";"200043K1-N1Ovaria";"15.08.00";21;0;21;4;17;0,19047619
"1136";"Sal3";"Ovaria";"200043P1-44IOvaria";"17.08.00";83;11;72;13;59;0,180555556
"1137";"Sal4";"Ofoeti";"200043S-I1Ofoeti";"16.08.00";69;0;69;14;55;0,202898551
"1138";"Sal3";"Ovaria";"200044E1-O1Ovaria";"15.08.00";57;0;57;20;37;0,350877193
"1139";"Sal3";"Ovaria";"200044L-SOvaria";"15.08.00";39;2;37;4;33;0,108108108
"1140";"Sal3";"Ovaria";"200044Q1-T1Ovaria";"15.08.00";19;0;19;2;17;0,105263158
"1141";"Sal3";"Ovaria";"200044U-C1Ovaria";"15.08.00";48;0;48;16;32;0,333333333
"1142";"Sal3";"Ovaria";"200045A1-G1Ovaria";"15.08.00";35;1;34;7;27;0,205882353
"1143";"Sal3";"Ovaria";"200045A-EOvaria";"15.08.00";26;0;26;10;16;0,384615385
"1144";"Sal3";"Ovaria";"200045G-VOvaria";"15.08.00";81;1;80;35;45;0,4375
"1145";"Sal23";"Oretic";"200045J1-46I1Oretic";"15.08.00";144;0;144;27;117;0,1875
"1146";"Sal23";"Oretic";"200046K1-47WOretic";"15.08.00";107;1;106;33;73;0,311320755
"1147";"Sal4";"Egemmf";"200047G1-N1Egemmf";"16.08.00";52;2;50;22;28;0,44
"1148";"Sal4";"Egemmf";"200047P1-Q1Egemmf";"15.08.00";11;0;11;8;3;0,727272727
"1149";"Sal4";"Egemmf";"200047S1-T1Egemmf";"16.08.00";14;0;14;4;10;0,285714286
"1150";"Sal4";"Egemmf";"200047V1Egemmf";"15.08.00";5;0;5;1;4;0,2
"1151";"Sal4";"Egemmf";"200047Y-E1Egemmf";"16.08.00";39;5;34;16;18;0,470588235
"1152";"Sal4";"Egemmf";"200048A-DEgemmf";"16.08.00";20;5;15;4;11;0,266666667
"1153";"Sal4";"Egemmf";"200048E-FEgemmf";"15.08.00";10;0;10;8;2;0,8
"1154";"Sal4";"Egemmf";"200048H1-J1Egemmf";"16.08.00";14;0;14;9;5;0,642857143
"1155";"Sal4";"Egemmf";"200048J-QEgemmf";"16.08.00";47;3;44;22;22;0,5
"1156";"Sal4";"Egemmf";"200048L1-P1Egemmf";"15.08.00";25;1;24;6;18;0,25
"1157";"Sal4";"Egemmf";"200048R1-49CEgemmf";"15.08.00";40;3;37;19;18;0,513513514
"1158";"Sal4";"Egemmf";"200048S-TEgemmf";"16.08.00";9;0;9;2;7;0,222222222
"1159";"Sal4";"Egemmf";"200048V-F1Egemmf";"16.08.00";71;1;70;15;55;0,214285714
"1160";"Sal4";"Egemmf";"200049A1-E1Egemmf";"15.08.00";30;2;28;19;9;0,678571429
"1161";"Sal4";"Egemmf";"200049E-FEgemmf";"16.08.00";11;0;11;2;9;0,181818182
"1162";"Sal4";"Egemmf";"200049G1Egemmf";"15.08.00";5;1;4;1;3;0,25
"1163";"Sal4";"Egemmf";"200049H-JEgemmf";"15.08.00";14;2;12;6;6;0,5
"1164";"Sal4";"Egemmf";"200049LEgemmf";"15.08.00";6;0;6;3;3;0,5
"1165";"Sal4";"Egemmf";"200049N-OEgemmf";"16.08.00";7;0;7;4;3;0,571428571
"1166";"Sal4";"Egemmf";"200049R-SEgemmf";"15.08.00";13;0;13;10;3;0,769230769
"1167";"Sal4";"Egemmf";"200049U-VEgemmf";"15.08.00";9;0;9;3;6;0,333333333
"1168";"Sal4";"Egemmf";"200049XEgemmf";"16.08.00";5;0;5;3;2;0,6
"1169";"Sal11";"Oproxi";"200061A-MOproxi";"04.09.00";67;2;65;43;22;0,661538462
"1170";"Sal11";"Oproxi";"200061L1-P1Oproxi";"04.09.00";25;0;25;18;7;0,72
"1171";"Sal11";"Oproxi";"200061O-J1Oproxi";"04.09.00";110;0;110;44;66;0,4
"1172";"Sal11";"Oproxi";"200062A-GOproxi";"04.09.00";33;0;33;21;12;0,636363636
"1173";"Sal10";"Ovesic";"200062M-QOvesic";"04.09.00";16;0;16;6;10;0,375
"1174";"Sal31";"Hangli";"2000SZ10Hangli";"17.07.00";37;0;37;0;37;0
"1175";"Sal31";"Hangli";"2000SZ11Hangli";"17.07.00";51;21;30;12;18;0,4
"1176";"Sal31";"Hangli";"2000SZ12Hangli";"17.07.00";36;0;36;1;35;0,027777778
"1177";"Sal11";"Hoblit";"2000SZ13Hoblit";"17.07.00";37;4;33;0;33;0
"1178";"Sal31";"Hangli";"2000SZ14Hangli";"17.07.00";117;3;114;5;109;0,043859649
"1179";"Sal31";"Hangli";"2000SZ15Hangli";"17.07.00";30;0;30;11;19;0,366666667
"1180";"Sal11";"Hoblit";"2000SZ16Hoblit";"20.07.00";11;0;11;0;11;0
"1181";"Sal31";"Hangli";"2000SZ17Hangli";"17.07.00";24;0;24;0;24;0
"1182";"Sal2";"Hpscho";"2000SZ18Hpscho";"14.08.00";12;0;12;0;12;0
"1183";"Sal18";"Hleuco";"2000SZ19Hleuco";"14.08.00";8;0;8;0;8;0
"1184";"Sal10";"Hpolit";"2000SZ1Hpolit";"19.07.00";25;0;25;0;25;0
"1185";"Sal18";"Hleuco";"2000SZ20Hleuco";"14.08.00";20;0;20;2;18;0,1
"1186";"Sal31";"Hangli";"2000SZ21Hangli";"04.09.00";91;6;85;0;85;0
"1187";"Sal31";"Hangli";"2000SZ22Hangli";"05.09.00";94;41;53;0;53;0
"1188";"Sal31";"Hangli";"2000SZ23Hangli";"07.09.00";93;1;92;0;92;0
"1189";"Sal12";"Hoblit";"2000SZ2424Hoblit";"05.09.00";93;1;92;1;91;0,010869565
"1190";"Sal11";"Hoblit";"2000SZ2Hoblit";"19.07.00";55;10;45;0;45;0
"1191";"Sal10";"Hpolit";"2000SZ3Hpolit";"19.07.00";45;2;43;2;41;0,046511628
"1192";"Sal31";"Hangli";"2000SZ4Hangli";"19.07.00";233;7;226;2;224;0,008849558
"1193";"Sal11";"Hoblit";"2000SZ5Hoblit";"19.07.00";35;1;34;0;34;0
"1194";"Sal11";"Hoblit";"2000SZ6Hoblit";"20.07.00";28;4;24;0;24;0
"1195";"Sal31";"Hangli";"2000SZ7Hangli";"17.07.00";99;26;73;4;69;0,054794521
"1196";"Sal31";"Hangli";"2000SZ8Hangli";"17.07.00";33;1;32;2;30;0,0625
"1197";"Sal31";"Hangli";"2000SZ9Hangli";"17.07.00";39;1;38;1;37;0,026315789
"1198";"Sal28";"Oherba";"200101A-Q1Oherba";"04.08.01";255;1;254;55;199;0,216535433
"1199";"Sal18";"Ospset";"200102A1-T1Ospset";"06.08.01";79;0;79;67;12;0,848101266
"1200";"Sal15";"Omyrsi";"200102A-YOmyrsi";"04.08.01";152;0;152;95;57;0,625
"1201";"Sal30";"Omyrti";"200103A-LOmyrti";"06.08.01";74;0;74;17;57;0,22972973
"1202";"Sal18";"Obridg";"200103G1-4DObridg";"12.08.01";121;3;118;65;53;0,550847458
"1203";"Sal18";"Ogalla";"200103N-QOgalla";"06.08.01";22;0;22;3;19;0,136363636
"1204";"Sal18";"Ospset";"200103S-E1Ospset";"07.08.01";53;0;53;43;10;0,811320755
"1205";"Sal41";"Oarcti";"200104F-NOarcti";"21.03.01";18;0;18;4;14;0,222222222
"1206";"Sal27";"Elanat";"200105A1-V1Elanat";"08.08.01";108;0;108;27;81;0,25
"1207";"Sal5";"Ehasta";"200105A-MEhasta";"10.08.01";65;0;65;12;53;0,184615385
"1208";"Sal30";"Emyrti";"200105O-WEmyrti";"07.08.01";46;0;46;38;8;0,826086957
"1209";"Sal30";"Esmyrt";"200105YEsmyrt";"07.08.01";4;0;4;2;2;0,5
"1210";"Sal30";"Emyrti";"200105ZEmyrti";"07.08.01";2;0;2;0;2;0
"1211";"Sal30";"Emyrti";"200106A-GEmyrti";"06.08.01";36;0;36;25;11;0,694444444
"1212";"Sal30";"Emyrti";"200106I-SEmyrti";"07.08.01";54;1;53;45;8;0,849056604
"1213";"Sal14";"Elappo";"200106U-7HElappo";"15.08.01";217;0;217;25;192;0,115207373
"1214";"Sal17";"Eboreo";"200107A1-D1Eboreo";"14.08.01";19;0;19;4;15;0,210526316
"1215";"Sal5";"Ehasta";"200107F1-K1Ehasta";"03.08.01";34;0;34;3;31;0,088235294
"1216";"Sal14";"Elappo";"200107J-VElappo";"19.08.01";51;0;51;2;49;0,039215686
"1217";"Sal5";"Ehasta";"200107M1-V1Ehasta";"10.08.01";58;0;58;5;53;0,086206897
"1218";"Sal17";"Eboreo";"200108A-HEboreo";"14.08.01";38;0;38;14;24;0,368421053
"1219";"Sal17";"Eboreo";"200108J-QEboreo";"19.08.01";39;0;39;9;30;0,230769231
"1220";"Sal9";"Eciner";"200108S-XEciner";"20.01.02";48;0;48;14;34;0,291666667
"1221";"Sal16";"Hnudip";"2001SZ0101Hnudip";"26.07.01";17;0;17;1;16;0,058823529
"1222";"Sal9";"Hpruss";"2001SZ01a01aHpruss";"25.06.01";126;2;124;0;124;0
"1223";"Sal17";"Hplicg";"2001SZ0202Hplicg";"03.08.01";12;1;11;0;11;0
"1224";"Sal16";"Hplicp";"2001SZ0303Hplicp";"03.08.01";25;6;19;5;14;0,263157895
"1225";"Sal16";"Hnudip";"2001SZ0404Hnudip";"03.08.01";25;5;20;2;18;0,1
"1226";"Sal3";"Hischn";"2001SZ0505Hischn";"02.08.01";44;19;25;4;21;0,16
"1227";"Sal16";"Hplicp";"2001SZ0606Hplicp";"02.08.01";27;10;17;3;14;0,176470588
"1228";"Sal3";"Hischn";"2001SZ0707Hischn";"02.08.01";69;26;43;4;39;0,093023256
"1229";"Sal16";"Hnudip";"2001SZ0808Hnudip";"02.08.01";33;9;24;3;21;0,125
"1230";"Sal16";"Hnudip";"2001SZ0909Hnudip";"03.08.01";8;0;8;1;7;0,125
"1231";"Sal3";"Hischn";"2001SZ1010Hischn";"03.08.01";13;2;11;1;10;0,090909091
"1232";"Sal16";"Hnudip";"2001SZ1111Hnudip";"03.08.01";1;0;1;0;1;0
"1233";"Sal16";"Hplicp";"2001SZ1212Hplicp";"05.08.01";8;1;7;0;7;0
"1234";"Sal14";"Hacuti";"2001SZ1313Hacuti";"05.08.01";15;7;8;0;8;0
"1235";"Sal14";"Hplicl";"2001SZ1414Hplicl";"05.08.01";88;19;69;2;67;0,028985507
"1236";"Sal3";"Hischn";"2001SZ1515Hischn";"05.08.01";4;2;2;0;2;0
"1237";"Sal17";"Hplicg";"2001SZ1616Hplicg";"05.08.01";56;11;45;9;36;0,2
"1238";"Sal16";"Hnudip";"2001SZ1717Hnudip";"05.08.01";20;4;16;9;7;0,5625
"1239";"Sal18";"Hscapr";"2001SZ1818Hscapr";"06.08.01";20;14;6;0;6;0
"1240";"Sal18";"Hleuco";"2001SZ1919Hleuco";"06.08.01";164;65;99;2;97;0,02020202
"1241";"Sal16";"Hnudip";"2001SZ2020Hnudip";"05.08.01";46;8;38;13;25;0,342105263
"1242";"Sal3";"Hischn";"2001SZ2121Hischn";"05.08.01";16;3;13;1;12;0,076923077
"1243";"Sal3";"Hischn";"2001SZ2222Hischn";"06.08.01";27;5;22;0;22;0
"1244";"Sal16";"Hnudip";"2001SZ2323Hnudip";"06.08.01";5;1;4;1;3;0,25
"1245";"Sal5";"Htuber";"2001SZ2424Htuber";"06.08.01";19;6;13;5;8;0,384615385
"1246";"Sal16";"Hnudip";"2001SZ2525Hnudip";"06.08.01";25;4;21;7;14;0,333333333
"1247";"Sal42";"Hacuti";"2001SZ2626Hacuti";"19.08.01";1;0;1;0;1;0
"1248";"Sal18";"Hscapr";"2001SZ2727Hscapr";"07.08.01";43;15;28;16;12;0,571428571
"1249";"Sal16";"Hnudip";"2001SZ2828Hnudip";"07.08.01";17;2;15;9;6;0,6
"1250";"Sal17";"Hplicg";"2001SZ2929Hplicg";"10.08.01";12;1;11;0;11;0
"1251";"Sal5";"Htuber";"2001SZ3030Htuber";"10.08.01";11;1;10;4;6;0,4
"1252";"Sal17";"Hplicg";"2001SZ3131Hplicg";"08.08.01";190;42;148;6;142;0,040540541
"1253";"Sal16";"Hnudip";"2001SZ3232Hnudip";"08.08.01";13;3;10;2;8;0,2
"1254";"Sal16";"Hnudip";"2001SZ3333Hnudip";"08.08.01";10;0;10;0;10;0
"1255";"Sal5";"Htuber";"2001SZ3434Htuber";"12.08.01";139;28;111;12;99;0,108108108
"1256";"Sal17";"Hplicg";"2001SZ3535Hplicg";"11.08.01";54;8;46;0;46;0
"1257";"Sal14";"Hacuti";"2001SZ3636Hacuti";"09.08.01";2;1;1;0;1;0
"1258";"Sal16";"Hnudip";"2001SZ3737Hnudip";"10.08.01";3;0;3;1;2;0,333333333
"1259";"Sal14";"Hacuti";"2001SZ3838Hacuti";"10.08.01";9;2;7;1;6;0,142857143
"1260";"Sal17";"Hplicg";"2001SZ3939Hplicg";"10.08.01";15;3;12;1;11;0,083333333
"1261";"Sal18";"Hleuco";"2001SZ4040Hleuco";"11.08.01";11;2;9;0;9;0
"1262";"Sal17";"Hplicg";"2001SZ4141Hplicg";"15.08.01";38;12;26;3;23;0,115384615
"1263";"Sal16";"Hnudip";"2001SZ4242Hnudip";"10.08.01";1;0;1;0;1;0
"1264";"Sal3";"Hischn";"2001SZ4343Hischn";"10.08.01";1;0;1;0;1;0
"1265";"Sal5";"Htuber";"2001SZ4444Htuber";"10.08.01";3;1;2;0;2;0
"1266";"Sal16";"Hnudip";"2001SZ4545Hnudip";"10.08.01";9;2;7;2;5;0,285714286
"1267";"Sal17";"Hplicg";"2001SZ4646Hplicg";"13.08.01";27;3;24;0;24;0
"1268";"Sal18";"Hanoma";"2001SZ4848Hanoma";"13.08.01";3;0;3;1;2;0,333333333
"1269";"Sal17";"Hplicg";"2001SZ4949Hplicg";"14.08.01";5;2;3;0;3;0
"1270";"Sal17";"Hplicg";"2001SZ5050Hplicg";"19.08.01";42;8;34;3;31;0,088235294
"1271";"Sal17";"Hplicg";"2001SZ5151Hplicg";"19.08.01";26;0;26;1;25;0,038461538
"1272";"Sal18";"Hanoma";"2001SZ5252Hanoma";"21.08.01";58;8;50;0;50;0
"1273";"Sal16";"Hnudip";"2001SZ5353Hnudip";"16.08.01";47;9;38;2;36;0,052631579
"1274";"Sal43";"Hacuti";"2001SZ5454Hacuti";"22.08.01";73;10;63;3;60;0,047619048
"1275";"Sal17";"Hplicg";"2001SZ5555Hplicg";"14.08.01";71;3;68;9;59;0,132352941
"1276";"Sal18";"Hleuco";"2001SZ5656Hleuco";"13.08.01";52;11;41;0;41;0
"1277";"Sal14";"Hacuti";"2001SZ5757Hacuti";"15.08.01";174;79;95;14;81;0,147368421
"1278";"Sal25";"Heryth";"2001SZ5858Heryth";"21.08.01";18;2;16;0;16;0
"1279";"Sal44";"Heryth";"2001SZ5959Heryth";"21.08.01";26;2;24;1;23;0,041666667
"1280";"Sal43";"Hplicl";"2001SZ6060Hplicl";"22.08.01";196;10;186;4;182;0,021505376
"1281";"Sal25";"Halien";"2001SZ6161Halien";"21.08.01";102;47;55;3;52;0,054545455
"1282";"Sal44";"Halien";"2001SZ6262Halien";"21.08.01";117;55;62;0;62;0
"1283";"Sal16";"Ephyli";"2001SZ6767Ephyli";"03.08.01";245;12;233;42;191;0,180257511
"1284";"Sal14";"Elappo";"2001SZ7575Elappo";"09.09.01";168;7;161;7;154;0,043478261
"1285";"Sal17";"Eboreo";"2001SZ8080Eboreo";"14.08.01";38;0;38;0;38;0
"1286";"Sal17";"Eboreo";"2001SZ8181Eboreo";"19.08.01";22;0;22;0;22;0
"1287";"Sal17";"Eboreo";"2001SZ8282Eboreo";"08.08.01";36;0;36;6;30;0,166666667
"1288";"Sal25";"Eaurit";"2001SZ8383Eaurit";"08.08.01";4;0;4;2;2;0,5
"1289";"Sal11";"Eatraa";"2001SZ8484Eatraa";"15.03.02";10;0;10;3;7;0,3
"1290";"Sal11";"Oproxi";"200201A-N1Oproxi";"29.07.02";153;0;153;99;54;0,647058824
"1291";"Sal2";"Obridg";"200202A1-S1Obridg";"08.08.02";37;1;36;27;9;0,75
"1292";"Sal11";"Oproxi";"200202A-YOproxi";"31.07.02";96;2;94;76;18;0,808510638
"1293";"Sal2";"Obridg";"200202U1-V1Obridg";"07.08.02";7;0;7;4;3;0,571428571
"1294";"Sal20";"Oobscu";"200203A1-G1Oobscu";"06.08.02";20;0;20;7;13;0,35
"1295";"Sal20";"Omonti";"200203A-YOmonti";"08.08.02";123;4;119;11;108;0,092436975
"1296";"Sal36";"Obridg";"200203I1-L1Obridg";"07.08.02";7;0;7;3;4;0,428571429
"1297";"Sal10";"Ovimin";"198203W1-R3Ovimin";"15.06.82";48;0;48;19;29;0,395833333
"1298";"Sal10";"Ovimin";"198204A-V1Ovimin";"15.06.82";51;0;51;27;24;0,529411765
"1299";"Sal18";"Obridg";"198205A1-V1Obridg";"15.06.82";25;4;21;12;9;0,571428571
"1300";"Sal18";"Ogalla";"198205A-ZOgalla";"15.06.82";32;0;32;31;1;0,96875
"1301";"Sal10";"Ovesic";"198206A-IOvesic";"15.06.82";11;0;11;2;9;0,181818182
"1302";"Sal10";"Ovesic";"198206J-V1Ovesic";"15.06.82";56;0;56;26;30;0,464285714
"1303";"Sal9";"Opedun";"198207A-V1Opedun";"15.06.82";50;0;50;38;12;0,76
"1304";"Sal10";"Ovimin";"198208A-L1Ovimin";"15.06.82";38;0;38;26;12;0,684210526
"1305";"Sal10";"Ovesic";"198209A-14V1Ovesic";"15.06.82";423;9;414;250;164;0,603864734
"1306";"Sal26";"Otrian";"198215A-G1Otrian";"26.06.82";34;3;31;18;13;0,580645161
"1307";"Sal12";"Oproxi";"198215H1-16V1Oproxi";"23.06.82";72;0;72;59;13;0,819444444
"1308";"Sal12";"Oproxi";"198217A-V1Oproxi";"23.06.82";86;1;85;56;29;0,658823529
"1309";"Sal10";"Ovimin";"198218A1-19ZOvimin";"23.06.82";48;0;48;1;47;0,020833333
"1310";"Sal12";"Oproxi";"198218A-ZOproxi";"23.06.82";42;4;38;27;11;0,710526316
"1311";"Sal9";"Obridg";"198220A1-V1Obridg";"29.06.82";23;1;22;11;11;0,5
"1312";"Sal9";"Opedun";"198220A-ZOpedun";"29.06.82";31;3;28;14;14;0,5
"1313";"Sal10";"Ovimin";"198221A-V1Ovimin";"29.06.82";48;0;48;19;29;0,395833333
"1314";"Sal25";"Obella";"198222A-V1Obella";"30.06.82";51;1;50;26;24;0,52
"1315";"Sal11";"Oproxi";"198223A-V1Oproxi";"30.06.82";61;1;60;43;17;0,716666667
"1316";"Sal2";"Obridg";"198224A-V1Obridg";"06.07.82";57;0;57;4;53;0,070175439
"1317";"Sal2";"Obridg";"198225A-V1Obridg";"06.07.82";65;0;65;3;62;0,046153846
"1318";"Sal5";"Ohasta";"198226A-V1Ohasta";"07.07.82";53;4;49;1;48;0,020408163
"1319";"Sal3";"Onigri";"198227P-ZOnigri";"07.07.82";14;0;14;2;12;0,142857143
"1320";"Sal3";"Ovaria";"198229A-V1Ovaria";"08.07.82";62;0;62;0;62;0
"1321";"Sal2";"Obridg";"198230A-31VObridg";"08.07.82";85;0;85;5;80;0,058823529
"1322";"Sal8";"Onival";"198231U-V1Onival";"09.07.82";36;0;36;0;36;0
"1323";"Sal10";"Ovesic";"198234A-35V1Ovesic";"20.07.82";157;0;157;106;51;0,675159236
"1324";"Sal10";"Ovimin";"198236A-V1Ovimin";"20.07.82";49;0;49;33;16;0,673469388
"1325";"Sal11";"Oproxi";"198237A-V1Oproxi";"20.07.82";55;13;42;38;4;0,904761905
"1326";"Sal3";"Ovaria";"198238A-39V1Ovaria";"01.08.82";163;0;163;16;147;0,098159509
"1327";"Sal3";"Onigri";"198240A-V1Onigri";"01.08.82";85;0;85;32;53;0,376470588
"1328";"Sal10";"Ovesic";"198241A-V1Ovesic";"01.08.82";53;0;53;3;50;0,056603774
"1329";"Sal4";"Oobscu";"198242A-H1Oobscu";"01.08.82";38;10;28;21;7;0,75
"1330";"Sal3";"Ovaria";"198243A-V1Ovaria";"01.08.82";97;0;97;8;89;0,082474227
"1331";"Sal4";"Ofoeti";"198244A1-V1Ofoeti";"02.08.82";21;0;21;0;21;0
"1332";"Sal3";"Onigri";"198244A-ZOnigri";"02.08.82";42;0;42;9;33;0,214285714
"1333";"Sal10";"Ovesic";"198245A-V1Ovesic";"01.08.82";44;0;44;3;41;0,068181818
"1334";"Sal2";"Obridg";"198246A-LObridg";"02.08.82";12;4;8;2;6;0,25
"1335";"Sal2";"Obridg";"198246M-47V1Obridg";"02.08.82";204;15;189;3;186;0,015873016
"1336";"Sal24";"Oretus";"198248A-49E1Oretus";"04.08.82";79;13;66;5;61;0,075757576
"1337";"Sal2";"Obridg";"198250A-D1Obridg";"05.08.82";59;12;47;0;47;0
"1338";"Sal10";"Ovimin";"198251A-MOvimin";"11.08.82";9;0;9;7;2;0,777777778
"1339";"Sal10";"Ovimin";"198251L1-V1Ovimin";"11.08.82";16;2;14;7;7;0,5
"1340";"Sal10";"Ovimin";"198251N-K1Ovimin";"11.08.82";25;3;22;17;5;0,772727273
"1341";"Sal11";"Oproxi";"198252A-V1Oproxi";"11.08.82";77;2;75;69;6;0,92
"1342";"Sal10";"Ovesic";"198253A-V1Ovesic";"11.08.82";88;13;75;42;33;0,56
"1343";"Sal11";"Oproxi";"198254A-55V1Oproxi";"24.08.82";136;14;122;95;27;0,778688525
"1344";"Sal4";"Ofoeti";"198256A1-V1Ofoeti";"29.08.82";36;5;31;3;28;0,096774194
"1345";"Sal4";"Oobscu";"198256A-WOobscu";"29.08.82";23;0;23;4;19;0,173913043
"1346";"Sal3";"Ovaria";"198257A-58V1Ovaria";"29.08.82";132;5;127;17;110;0,133858268
"1347";"Sal24";"Oretus";"198259A-61V1Oretus";"29.08.82";149;17;132;12;120;0,090909091
"1348";"Sal10";"Ovesic";"198262A-63V1Ovesic";"29.08.82";119;20;99;1;98;0,01010101
"1349";"Sal23";"Oretic";"198264A1-F1Oretic";"29.08.82";6;0;6;0;6;0
"1350";"Sal10";"Ovimin";"198264A-ROvimin";"29.08.82";18;5;13;5;8;0,384615385
"1351";"Sal7";"Omacul";"198265A1-J1Omacul";"31.08.82";10;0;10;1;9;0,1
"1352";"Sal5";"Ohasta";"198265A-ZOhasta";"31.08.82";26;3;23;10;13;0,434782609
"1353";"Sal8";"Onival";"198266A-ZOnival";"31.08.82";43;0;43;0;43;0
"1354";"Sal4";"Ofoeti";"198267A-V1Ofoeti";"01.09.82";96;1;95;11;84;0,115789474
"1355";"Sal4";"Omonti";"198268A-V1Omonti";"01.09.82";65;5;60;5;55;0,083333333
"1356";"Sal1";"Eelaea";"198269A-70V1Eelaea";"29.08.82";96;0;96;0;96;0
"1357";"Sal4";"Oobscu";"198271A1-V1Oobscu";"01.09.82";47;9;38;9;29;0,236842105
"1358";"Sal4";"Omonti";"198271A-ZOmonti";"01.09.82";52;5;47;3;44;0,063829787
"1359";"Sal10";"Ovimin";"198272A-73V1Ovimin";"14.09.82";107;1;106;58;48;0,547169811
"1360";"Sal12";"Oproxi";"198274A-75V1Oproxi";"14.09.82";372;96;276;88;188;0,31884058
"1361";"Sal12";"Oproxi";"198276A-V1Oproxi";"14.09.82";200;64;136;50;86;0,367647059
"1362";"Sal12";"Oproxi";"198277A-V1Oproxi";"14.09.82";187;61;126;31;95;0,246031746
"1363";"Sal9";"Obridg";"198278A-J1Obridg";"21.09.82";55;23;32;15;17;0,46875
"1364";"Sal11";"Oproxi";"198278K1-79Oproxi";"21.09.82";134;49;85;55;30;0,647058824
"1365";"Sal10";"Oviril";"198301A-4V1Oviril";"17.05.83";185;0;185;9;176;0,048648649
"1366";"Sal9";"Opedun";"198305A-V1Opedun";"15.06.83";68;6;62;30;32;0,483870968
"1367";"Sal9";"Opedun";"198306A-7V1Opedun";"14.06.83";103;9;94;30;64;0,319148936
"1368";"Sal9";"Obridg";"198308A-V1Obridg";"15.06.83";36;3;33;26;7;0,787878788
"1369";"Sal10";"Ovimin";"198309A-M1Ovimin";"21.06.83";39;0;39;12;27;0,307692308
"1370";"Sal18";"Obridg";"198310A-V1Obridg";"21.06.83";47;7;40;19;21;0,475
"1371";"Sal9";"Opedun";"198311A-V1Opedun";"21.06.83";50;5;45;9;36;0,2
"1372";"Sal10";"Ovesic";"198312A-13V1Ovesic";"21.06.83";134;2;132;22;110;0,166666667
"1373";"Sal12";"Oproxi";"198314A-16V1Oproxi";"22.06.83";197;12;185;97;88;0,524324324
"1374";"Sal12";"Oproxi";"198317A-18V1Oproxi";"22.06.83";149;14;135;112;23;0,82962963
"1375";"Sal12";"Oproxi";"198319A-20V1Oproxi";"22.06.83";228;42;186;148;38;0,795698925
"1376";"Sal26";"Otrian";"198321A-V1Otrian";"22.06.83";54;5;49;34;15;0,693877551
"1377";"Sal12";"Oproxi";"198322A-25V1Oproxi";"22.06.83";280;64;216;43;173;0,199074074
"1378";"Sal18";"Ogalla";"198326A-27VOgalla";"22.06.83";67;3;64;2;62;0,03125
"1379";"Sal10";"Ovimin";"198327Y-V1Ovimin";"22.06.83";25;0;25;7;18;0,28
"1380";"Sal7";"Ohelve";"198328A-30V1Ohelve";"28.06.83";213;17;196;8;188;0,040816327
"1381";"Sal3";"Onigri";"198331A-32I1Onigri";"04.07.83";129;40;89;8;81;0,08988764
"1382";"Sal3";"Onigri";"198333A-35V1Onigri";"06.07.83";243;46;197;41;156;0,208121827
"1383";"Sal3";"Onigri";"198336A-V1Onigri";"06.07.83";93;22;71;16;55;0,225352113
"1384";"Sal6";"Oadaph";"198338A-V1Oadaph";"21.08.83";56;2;54;19;35;0,351851852
"1385";"Sal3";"Ovaria";"198339A-V1Ovaria";"21.08.83";96;1;95;54;41;0,568421053
"1386";"Sal23";"Oretic";"198340A-41V1Oretic";"16.08.83";72;10;62;48;14;0,774193548
"1387";"Sal7";"Omacul";"198342A-43V1Omacul";"17.08.83";101;1;100;15;85;0,15
"1388";"Sal8";"Onival";"198344A-V1Onival";"17.08.83";48;6;42;2;40;0,047619048
"1389";"Sal5";"Ohasta";"198345A-V1Ohasta";"17.08.83";40;5;35;9;26;0,257142857
"1390";"Sal5";"Ohasta";"198346A-47V1Ohasta";"18.08.83";192;30;162;25;137;0,154320988
"1391";"Sal3";"Ovaria";"198348A-V1Ovaria";"18.08.83";96;4;92;18;74;0,195652174
"1392";"Sal10";"Ovesic";"198349A-50V1Ovesic";"22.08.83";194;39;155;56;99;0,361290323
"1393";"Sal4";"Omonti";"198351A1-L1Omonti";"22.08.83";12;0;12;5;7;0,416666667
"1394";"Sal4";"Ofoeti";"198351A-ZOfoeti";"22.08.83";52;0;52;15;37;0,288461538
"1395";"Sal10";"Ovimin";"198351M1-V1Ovimin";"22.08.83";30;0;30;6;24;0,2
"1396";"Sal4";"Oobscu";"198352A-V1Oobscu";"22.08.83";98;25;73;45;28;0,616438356
"1397";"Sal4";"Ofoeti";"198353A-V1Ofoeti";"23.08.83";96;3;93;27;66;0,290322581
"1398";"Sal3";"Ovaria";"198354A-V1Ovaria";"23.08.83";96;3;93;72;21;0,774193548
"1399";"Sal24";"Oretus";"198355A-57V1Oretus";"23.08.83";278;3;275;52;223;0,189090909
"1400";"Sal4";"Omonti";"198358A-V1Omonti";"23.08.83";24;0;24;0;24;0
"1401";"Sal10";"Ovesic";"198359A-K1Ovesic";"06.09.83";45;3;42;17;25;0,404761905
"1402";"Sal10";"Ovimin";"198360A-XOvimin";"06.09.83";40;2;38;29;9;0,763157895
"1403";"Sal9";"Obridg";"198360Y-T1Obridg";"06.09.83";40;6;34;29;5;0,852941176
"1404";"Sal26";"Otrian";"198361A-MOtrian";"07.09.83";27;7;20;7;13;0,35
"1405";"Sal11";"Oproxi";"198361O-V1Oproxi";"06.09.83";69;5;64;59;5;0,921875
"1406";"Sal12";"Oproxi";"198362A-V1Oproxi";"07.09.83";103;1;102;95;7;0,931372549
"1407";"Sal12";"Oproxi";"198363A-V1Oproxi";"07.09.83";74;17;57;26;31;0,456140351
"1408";"Sal12";"Oproxi";"198364A-V1Oproxi";"07.09.83";99;11;88;13;75;0,147727273
"1409";"Sal12";"Oproxi";"198365A-68V1Oproxi";"07.09.83";400;89;311;79;232;0,254019293
"1410";"Sal3";"Ovaria";"198369A-71V1Ovaria";"04.10.83";299;0;299;49;250;0,163879599
"1411";"Sal10";"Oviril";"198401A-4V1Oviril";"05.07.84";259;0;259;2;257;0,007722008
"1412";"Sal7";"Ohelve";"198405A-V1Ohelve";"07.07.84";69;5;64;0;64;0
"1413";"Sal9";"Opedun";"198406A-I1Opedun";"12.07.84";38;1;37;16;21;0,432432432
"1414";"Sal9";"Opedun";"198406J1-7LOpedun";"12.07.84";41;1;40;5;35;0,125
"1415";"Sal9";"Obridg";"198407R-ZObridg";"12.07.84";17;1;16;0;16;0
"1416";"Sal18";"Ogalla";"198408A-I1Ogalla";"19.07.84";35;0;35;7;28;0,2
"1417";"Sal18";"Obridg";"198409A-J1Obridg";"19.07.84";62;1;61;47;14;0,770491803
"1418";"Sal18";"Obridg";"198409K1-Q1Obridg";"18.07.84";14;2;12;5;7;0,416666667
"1419";"Sal31";"Hangli";"198412A-JHangli";"24.07.84";10;0;10;1;9;0,1
"1420";"Sal18";"Ogalla";"198414S-G1Ogalla";"25.07.84";15;0;15;4;11;0,266666667
"1421";"Sal10";"Ovesic";"198415A-19ZOvesic";"11.08.84";474;7;467;174;293;0,372591006
"1422";"Sal10";"Ovimin";"198419A1-V1Ovimin";"11.08.84";41;0;41;9;32;0,219512195
"1423";"Sal6";"Oadaph";"198420A-21ZOadaph";"11.08.84";175;3;172;95;77;0,552325581
"1424";"Sal5";"Ohasta";"198421A1-22ZOhasta";"11.08.84";109;0;109;72;37;0,660550459
"1425";"Sal26";"Otrian";"198422A1-V1Otrian";"11.08.84";55;21;34;0;34;0
"1426";"Sal6";"Oadaph";"198423A-V1Oadaph";"11.08.84";108;3;105;67;38;0,638095238
"1427";"Sal7";"Ohelve";"198424A-25V1Ohelve";"12.08.84";198;34;164;14;150;0,085365854
"1428";"Sal7";"Ohelve";"198426A-V1Ohelve";"12.08.84";64;17;47;2;45;0,042553191
"1429";"Sal7";"Omacul";"198427A-29JOmacul";"12.08.84";211;9;202;41;161;0,202970297
"1430";"Sal10";"Ovimin";"198429A1-V1Ovimin";"13.08.84";60;0;60;3;57;0,05
"1431";"Sal7";"Ohelve";"198429L-SOhelve";"12.08.84";14;0;14;0;14;0
"1432";"Sal1";"Okriec";"198430A-M1Okriec";"13.08.84";78;35;43;10;33;0,23255814
"1433";"Sal3";"Ovaria";"198431A-SOvaria";"13.08.84";57;0;57;37;20;0,649122807
"1434";"Sal3";"Ovaria";"198432A-33V1Ovaria";"13.08.84";293;0;293;20;273;0,068259386
"1435";"Sal7";"Omacul";"198434A-Q1Omacul";"14.08.84";80;9;71;11;60;0,154929577
"1436";"Sal5";"Ohasta";"198435A-V1Ohasta";"14.08.84";98;0;98;32;66;0,326530612
"1437";"Sal3";"Ovaria";"198436A-G1Ovaria";"14.08.84";67;1;66;13;53;0,196969697
"1438";"Sal22";"Obrevi";"198436I1-37WObrevi";"14.08.84";64;0;64;7;57;0,109375
"1439";"Sal10";"Oviril";"198437A1-L1Oviril";"14.08.84";24;2;22;18;4;0,818181818
"1440";"Sal10";"Ovimin";"198437M1-V1Ovimin";"14.08.84";43;0;43;12;31;0,279069767
"1441";"Sal6";"Oadaph";"198439A-40OOadaph";"15.08.84";191;8;183;106;77;0,579234973
"1442";"Sal24";"Oretus";"198440Q-41ZOretus";"15.08.84";196;0;196;63;133;0,321428571
"1443";"Sal5";"Ohasta";"198441A1-42L1Ohasta";"15.08.84";120;2;118;73;45;0,618644068
"1444";"Sal7";"Omacul";"198442N1-V1Omacul";"15.08.84";27;5;22;13;9;0,590909091
"1445";"Sal5";"Ohasta";"198443A-44SOhasta";"15.08.84";218;0;218;73;145;0,334862385
"1446";"Sal10";"Ovimin";"198445A1-D1Ovimin";"15.08.84";12;0;12;8;4;0,666666667
"1447";"Sal4";"Ofoeti";"198445F1-V1Ofoeti";"15.08.84";51;3;48;32;16;0,666666667
"1448";"Sal4";"Ofoeti";"198446A1-47N1Ofoeti";"16.08.84";186;0;186;104;82;0,559139785
"1449";"Sal3";"Ovaria";"198446A-YOvaria";"16.08.84";76;0;76;39;37;0,513157895
"1450";"Sal4";"Oobscu";"198448A-49J1Oobscu";"16.08.84";243;35;208;36;172;0,173076923
"1451";"Sal7";"Omacul";"198449L1-P1Omacul";"16.08.84";10;0;10;7;3;0,7
"1452";"Sal7";"Omacul";"198450A-V1Omacul";"17.08.84";123;2;121;24;97;0,198347107
"1453";"Sal8";"Onival";"198451A-LOnival";"17.08.84";23;0;23;5;18;0,217391304
"1454";"Sal5";"Ohasta";"198451N-UOhasta";"17.08.84";16;0;16;0;16;0
"1455";"Sal22";"Obrevi";"198452A-V1Obrevi";"18.08.84";97;0;97;8;89;0,082474227
"1456";"Sal3";"Ovaria";"198453A-V1Ovaria";"18.08.84";132;0;132;5;127;0,037878788
"1457";"Sal5";"Ohasta";"198454A-55V1Ohasta";"18.08.84";292;0;292;27;265;0,092465753
"1458";"Sal8";"Onival";"198457A-B1Onival";"19.08.84";90;0;90;3;87;0,033333333
"1459";"Sal7";"Egemmh";"198458A-U1Egemmh";"19.08.84";125;14;111;63;48;0,567567568
"1460";"Sal24";"Oretus";"198459A-LOretus";"19.08.84";29;0;29;14;15;0,482758621
"1461";"Sal3";"Ovaria";"198460A1-61SOvaria";"22.08.84";127;0;127;55;72;0,433070866
"1462";"Sal6";"Oadaph";"198460A-ZOadaph";"22.08.84";56;0;56;12;44;0,214285714
"1463";"Sal13";"Ocolla";"198462A-63V1Ocolla";"06.08.84";93;9;84;15;69;0,178571429
"1464";"Sal9";"Obridg";"198464A-NObridg";"06.08.84";14;0;14;0;14;0
"1465";"Sal9";"Opedun";"198464Q-A1Opedun";"06.08.84";19;0;19;0;19;0
"1466";"Sal18";"Ogalla";"198465A-XOgalla";"17.09.84";47;0;47;0;47;0
"1467";"Sal3";"Onigri";"198501A-V1Onigri";"09.07.85";97;18;79;12;67;0,151898734
"1468";"Sal16";"Odolic";"198502A-TOdolic";"09.07.85";50;5;45;9;36;0,2
"1469";"Sal16";"Oarcti";"198502Y-V1Oarcti";"09.07.85";36;1;35;3;32;0,085714286
"1470";"Sal3";"Onigri";"198503A-H1Onigri";"10.07.85";67;4;63;42;21;0,666666667
"1471";"Sal3";"Ovaria";"198503I1-V1+4Ovaria";"10.07.85";160;2;158;46;112;0,291139241
"1472";"Sal18";"Obridg";"198505A-V1Obridg";"10.07.85";80;9;71;34;37;0,478873239
"1473";"Sal3";"Onigri";"198506A-V1Onigri";"11.07.85";120;27;93;58;35;0,623655914
"1474";"Sal18";"Obridg";"198507A-V1Obridg";"11.07.85";63;6;57;51;6;0,894736842
"1475";"Sal3";"Ovaria";"198508A-Q1Ovaria";"11.07.85";82;0;82;13;69;0,158536585
"1476";"Sal3";"Onigri";"198508S1-V1Onigri";"11.07.85";8;1;7;4;3;0,571428571
"1477";"Sal3";"Ovaria";"198509A-V1Ovaria";"11.07.85";96;0;96;10;86;0,104166667
"1478";"Sal17";"Oglauc";"198510A-12V1Oglauc";"12.07.85";288;57;231;67;164;0,29004329
"1479";"Sal17";"Onival";"198513A-V1Onival";"12.07.85";96;7;89;10;79;0,112359551
"1480";"Sal27";"Oglabr";"198514A-V1Oglabr";"12.07.85";100;4;96;2;94;0,020833333
"1481";"Sal23";"Oretic";"198515A-V1Oretic";"12.07.85";100;0;100;3;97;0,03
"1482";"Sal17";"Oglauc";"198520A-V1Oglauc";"15.07.85";100;17;83;34;49;0,409638554
"1483";"Sal17";"Onival";"198521A1-22V1Onival";"15.07.85";152;1;151;9;142;0,059602649
"1484";"Sal14";"Olappo";"198523A-V1Olappo";"15.07.85";100;0;100;4;96;0,04
"1485";"Sal14";"Olappo";"198524A-26V1Olappo";"15.07.85";300;4;296;26;270;0,087837838
"1486";"Sal29";"Onorve";"198527A-28Q1Onorve";"18.07.85";200;0;200;3;197;0,015
"1487";"Sal14";"Olappl";"198528R1-V1Olappl";"18.07.85";15;0;15;4;11;0,266666667
"1488";"Sal16";"Oarcti";"198529A-30SOarcti";"23.07.85";132;5;127;31;96;0,244094488
"1489";"Sal45";"Ospset";"198530A1-S1Ospset";"23.07.85";36;3;33;31;2;0,939393939
"1490";"Sal16";"Odolic";"198530T-ZOdolic";"23.07.85";27;10;17;17;0;1
"1491";"Sal18";"Ospset";"198531A-32V1Ospset";"23.07.85";200;22;178;157;21;0,882022472
"1492";"Sal17";"Onival";"198533A1-V1Onival";"23.07.85";76;0;76;21;55;0,276315789
"1493";"Sal29";"Onorve";"198533A-ZOnorve";"23.07.85";68;0;68;14;54;0,205882353
"1494";"Sal16";"Oarcti";"198534A-V1Oarcti";"24.07.85";119;1;118;37;81;0,313559322
"1495";"Sal16";"Oarcti";"198535A1-37Oarcti";"25.07.85";354;4;350;88;262;0,251428571
"1496";"Sal17";"Onival";"198535A-SOnival";"24.07.85";38;0;38;4;34;0,105263158
"1497";"Sal14";"Osamol";"198538A-V1Osamol";"25.07.85";150;0;150;63;87;0,42
"1498";"Sal30";"Omyrti";"198539A1-V1Omyrti";"28.07.85";88;2;86;33;53;0,38372093
"1499";"Sal17";"Onival";"198539A-ZOnival";"25.07.85";80;2;78;19;59;0,243589744
"1500";"Sal30";"Emyrti";"198540A-V1Emyrti";"28.07.85";127;0;127;2;125;0,015748031
"1501";"Sal29";"Onorve";"198541A-QOnorve";"28.07.85";51;0;51;13;38;0,254901961
"1502";"Sal29";"Onorve";"198541H1-V1Onorve";"28.07.85";60;0;60;14;46;0,233333333
"1503";"Sal29";"Onorve";"198541S-F1Onorve";"28.07.85";43;0;43;11;32;0,255813953
"1504";"Sal17";"Onival";"198542A-V1Onival";"28.07.85";150;0;150;31;119;0,206666667
"1505";"Sal3";"Ovaria";"198543A-I1Ovaria";"28.07.85";105;2;103;47;56;0,45631068
"1506";"Sal16";"Oarcti";"198543J1-V1Oarcti";"28.07.85";52;0;52;7;45;0,134615385
"1507";"Sal16";"Oarcti";"198544A-J1Oarcti";"28.07.85";98;0;98;5;93;0,051020408
"1508";"Sal14";"Osamol";"198544K1-V1Osamol";"28.07.85";60;0;60;19;41;0,316666667
"1509";"Sal27";"Oglabr";"198545A-R1Oglabr";"30.07.85";132;2;130;72;58;0,553846154
"1510";"Sal3";"Ovaria";"198546S-P1Ovaria";"31.07.85";73;0;73;47;26;0,643835616
"1511";"Sal30";"Omyrti";"198547A-48V1Omyrti";"31.07.85";298;0;298;206;92;0,691275168
"1512";"Sal15";"Omyrsi";"198549A-J1Omyrsi";"01.08.85";113;0;113;6;107;0,053097345
"1513";"Sal15";"Ospeit";"198549K1-R1Ospeit";"01.08.85";29;18;11;4;7;0,363636364
"1514";"Sal3";"Ovaria";"198550A-H1Ovaria";"02.08.85";101;0;101;41;60;0,405940594
"1515";"Sal14";"Elappo";"198551A-N1Elappo";"07.08.85";65;1;64;1;63;0,015625
"1516";"Sal14";"Elappc";"198551O1-V1Elappc";"07.08.85";10;0;10;6;4;0,6
"1517";"Sal30";"Omyrti";"198552A-V1Omyrti";"07.08.85";117;1;116;84;32;0,724137931
"1518";"Sal29";"Onorve";"198553A-E1Onorve";"11.08.85";93;0;93;66;27;0,709677419
"1519";"Sal29";"Onorve";"198553F1-54V1Onorve";"12.08.85";196;0;196;54;142;0,275510204
"1520";"Sal14";"Olappo";"198555A-56ROlappo";"14.08.85";198;0;198;113;85;0,570707071
"1521";"Sal28";"Oherba";"198556T-P1Oherba";"14.08.85";69;2;67;5;62;0,074626866
"1522";"Sal5";"Ohasta";"198557A-58ZOhasta";"15.08.85";222;0;222;7;215;0,031531532
"1523";"Sal6";"Oadaph";"198559A-63V1Oadaph";"09.09.85";500;13;487;5;482;0,01026694
"1524";"Sal11";"Oproxi";"198564A-65H1Oproxi";"15.09.85";252;0;252;31;221;0,123015873
"1525";"Sal11";"Oproxi";"198566A-V1Oproxi";"15.09.85";100;0;100;19;81;0,19
"1526";"Sal18";"Ogalla";"198567A-LOgalla";"22.09.85";23;1;22;0;22;0
"1527";"Sal25";"Emucro";"198568A-70JEmucro";"05.10.85";318;0;318;40;278;0,125786164
"1528";"Sal1";"Okriec";"198570A1-71G1Okriec";"06.10.85";165;0;165;148;17;0,896969697
"1529";"Sal25";"Obella";"198570M-ZObella";"05.10.85";48;0;48;35;13;0,729166667
"1530";"Sal18";"Ogalla";"198571K1-V1Ogalla";"06.10.85";25;0;25;23;2;0,92
"1531";"Sal10";"Ovimin";"198572A-JOvimin";"06.10.85";21;0;21;21;0;1
"1532";"Sal10";"Ovesic";"198572M-J1Ovesic";"06.10.85";24;0;24;9;15;0,375
"1533";"Sal6";"Oadaph";"198573A-75Oadaph";"18.11.85";414;23;391;173;218;0,442455243
"1534";"Sal14";"Olappo";"1985SZ24-26AOlappo";"15.07.85";110;0;110;0;110;0
"1535";"Sal14";"Olappo";"1985SZ24-26BOlappo";"15.07.85";100;0;100;0;100;0
"1536";"Sal14";"Olappo";"1985SZ24-26COlappo";"15.07.85";110;0;110;4;106;0,036363636
"1537";"Sal29";"Onorve";"1985SZ27-28Onorve";"16.07.85";110;0;110;0;110;0
"1538";"Sal16";"Oarcti";"1985SZAOarcti";"02.08.85";134;0;134;0;134;0
"1539";"Sal16";"Oarcti";"1985SZBOarcti";"02.08.85";126;0;126;0;126;0
"1540";"Sal5";"Ohasta";"1985SZCOhasta";"05.08.85";200;0;200;1;199;0,005
"1541";"Sal14";"Osamol";"1985SZDOsamol";"06.08.85";160;0;160;1;159;0,00625
"1542";"Sal14";"Osamol";"1985SZEOsamol";"06.08.85";75;0;75;0;75;0
"1543";"Sal5";"Ohasta";"1985SZFOhasta";"06.08.85";80;0;80;0;80;0
"1544";"Sal46";"Ohasta";"1985SZGOhasta";"06.08.85";91;0;91;3;88;0,032967033
"1545";"Sal47";"Osamol";"1985SZHOsamol";"08.08.85";82;0;82;13;69;0,158536585
"1546";"Sal47";"Osamol";"1985SZIOsamol";"08.08.85";146;0;146;2;144;0,01369863
"1547";"Sal10";"Oviril";"198602A-S1Oviril";"10.06.86";131;7;124;40;84;0,322580645
"1548";"Sal10";"Ovesic";"198603A1-V1Ovesic";"10.06.86";71;0;71;32;39;0,450704225
"1549";"Sal10";"Ovimin";"198603A-ZOvimin";"10.06.86";78;0;78;26;52;0,333333333
"1550";"Sal9";"Opedun";"198604A-LOpedun";"10.06.86";38;0;38;33;5;0,868421053
"1551";"Sal9";"Opedun";"198604D1-J1Opedun";"10.06.86";22;0;22;14;8;0,636363636
"1552";"Sal10";"Ovimin";"198604K1-V1Ovimin";"10.06.86";58;0;58;10;48;0,172413793
"1553";"Sal9";"Opedun";"198604N-ROpedun";"10.06.86";15;0;15;11;4;0,733333333
"1554";"Sal9";"Obridg";"198604T-B1Obridg";"10.06.86";28;0;28;14;14;0,5
"1555";"Sal12";"Oproxi";"198605A-6V1Oproxi";"11.06.86";321;8;313;264;49;0,843450479
"1556";"Sal12";"Oproxi";"198607A-8V1Oproxi";"11.06.86";344;16;328;302;26;0,920731707
"1557";"Sal26";"Otrian";"198609A-N1Otrian";"24.06.86";80;7;73;51;22;0,698630137
"1558";"Sal9";"Opedun";"198610A-D1Opedun";"24.06.86";59;0;59;8;51;0,13559322
"1559";"Sal9";"Obridg";"198610F1-V1Obridg";"24.06.86";34;0;34;10;24;0,294117647
"1560";"Sal12";"Oproxi";"198611A-V1Oproxi";"25.06.86";270;4;266;238;28;0,894736842
"1561";"Sal9";"Obridg";"198612A-T1Obridg";"24.06.86";91;0;91;30;61;0,32967033
"1562";"Sal18";"Obridg";"198613A-14RObridg";"24.06.86";132;0;132;89;43;0,674242424
"1563";"Sal18";"Obridg";"198614A1-15G1Obridg";"25.06.86";110;0;110;84;26;0,763636364
"1564";"Sal18";"Ogalla";"198615I1-S1Ogalla";"25.06.86";22;0;22;4;18;0,181818182
"1565";"Sal12";"Oproxi";"198616A-V1Oproxi";"25.06.86";168;9;159;92;67;0,578616352
"1566";"Sal18";"Hleuco";"198617A-V1Hleuco";"01.07.86";26;6;20;2;18;0,1
"1567";"Sal9";"Opedun";"198626A-V1Opedun";"15.07.86";144;0;144;57;87;0,395833333
"1568";"Sal9";"Opedun";"198629A-OOpedun";"15.07.86";46;0;46;32;14;0,695652174
"1569";"Sal6";"Oadaph";"198629G1-V1Oadaph";"15.07.86";60;2;58;21;37;0,362068966
"1570";"Sal9";"Obridg";"198629Q-E1Obridg";"15.07.86";45;6;39;31;8;0,794871795
"1571";"Sal12";"Oproxi";"198630A1-V1Oproxi";"16.07.86";68;2;66;65;1;0,984848485
"1572";"Sal9";"Opedun";"198630A-ZOpedun";"15.07.86";78;0;78;44;34;0,564102564
"1573";"Sal11";"Oproxi";"198632A-V1Oproxi";"16.07.86";192;11;181;127;54;0,701657459
"1574";"Sal10";"Ovimin";"198633A-V1Ovimin";"17.07.86";168;0;168;73;95;0,43452381
"1575";"Sal9";"Opedun";"198634A-F1Opedun";"17.07.86";126;4;122;58;64;0,475409836
"1576";"Sal11";"Oproxi";"200204A1-5GOproxi";"07.10.02";144;3;141;64;77;0,453900709
"1577";"Sal48";"Oaacut";"200204A-ZOaacut";"02.10.02";58;6;52;12;40;0,230769231
"1578";"Sal11";"Oproxi";"200205I-WOproxi";"07.10.02";63;2;61;28;33;0,459016393
"1579";"Sal34";"Eatraa";"200269HEatraa";"04.04.03";7;0;7;0;7;0
"1580";"Sal31";"Hangli";"2002SZ01Hangli";"16.06.02";193;9;184;0;184;0
"1581";"Sal31";"Hangli";"2002SZ02Hangli";"29.06.02";218;17;201;6;195;0,029850746
"1582";"Sal9";"Hleuca";"2002SZ03Hleuca";"29.06.02";81;10;71;8;63;0,112676056
"1583";"Sal10";"Hpolit";"2002SZ04Hpolit";"07.08.02";134;19;115;3;112;0,026086957
"1584";"Sal10";"Hpurpu";"2002SZ05Hpurpu";"07.08.02";9;0;9;0;9;0
"1585";"Sal10";"Hpolit";"2002SZ06Hpolit";"07.08.02";206;63;143;0;143;0
"1586";"Sal2";"Hspira";"2002SZ07Hspira";"07.08.02";48;0;48;4;44;0,083333333
"1587";"Sal10";"Hpurpu";"2002SZ08Hpurpu";"07.08.02";52;28;24;8;16;0,333333333
"1588";"Sal6";"Hplicd";"2002SZ09Hplicd";"07.08.02";86;26;60;2;58;0,033333333
"1589";"Sal10";"Hpolit";"2002SZ10Hpolit";"07.08.02";107;50;57;2;55;0,035087719
"1590";"Sal6";"Hplicd";"2002SZ11Hplicd";"08.08.02";396;44;352;4;348;0,011363636
"1591";"Sal2";"Hspira";"2002SZ12Hspira";"07.08.02";77;47;30;7;23;0,233333333
"1592";"Sal2";"Hspira";"2002SZ13Hspira";"07.08.02";73;8;65;1;64;0,015384615
"1593";"Sal6";"Hplicd";"2002SZ14Hplicd";"07.08.02";503;91;412;3;409;0,007281553
"1594";"Sal2";"Hpscho";"2002SZ15Hpscho";"07.08.02";9;5;4;0;4;0
"1595";"Sal2";"Hspira";"2002SZ16Hspira";"06.08.02";22;13;9;1;8;0,111111111
"1596";"Sal2";"Hspira";"2002SZ17Hspira";"07.08.02";69;38;31;14;17;0,451612903
"1597";"Sal2";"Hspira";"2002SZ18Hspira";"07.08.02";80;43;37;3;34;0,081081081
"1598";"Sal3";"Hischn";"2002SZ19Hischn";"07.08.02";10;4;6;0;6;0
"1599";"Sal19";"Hischn";"2002SZ20Hischn";"08.08.02";48;9;39;1;38;0,025641026
"1600";"Sal11";"Oproxi";"200301A-D1Oproxi";"31.07.03";128;14;114;38;76;0,333333333
"1601";"Sal3";"Ovaria";"200301F1-2COvaria";"29.07.03";81;5;76;36;40;0,473684211
"1602";"Sal1";"Okriec";"200302A1-K1Okriec";"29.07.03";46;2;44;30;14;0,681818182
"1603";"Sal19";"Ovaria";"200302E-XOvaria";"01.08.03";80;1;79;73;6;0,924050633
"1604";"Sal19";"Onigri";"200303A-N1Onigri";"01.08.03";155;1;154;86;68;0,558441558
"1605";"Sal19";"Onigri";"200303P1-V1Onigri";"01.08.03";52;3;49;29;20;0,591836735
"1606";"Sal49";"Onigri";"200304A-L1Onigri";"01.08.03";153;2;151;67;84;0,443708609
"1607";"Sal49";"Odolic";"200305A-6V1Odolic";"01.08.03";609;5;604;540;64;0,894039735
"1608";"Sal18";"Ogalla";"200307A-DOgalla";"14.08.03";15;0;15;3;12;0,2
"1609";"Sal26";"Otrian";"200307F-MOtrian";"15.08.03";33;0;33;23;10;0,696969697
"1610";"Sal9";"Hleuca";"2003SZ02aHleuca";"21.06.03";73;2;71;9;62;0,126760563
"1611";"Sal9";"Hpruss";"2003SZ02bHpruss";"21.06.03";15;1;14;0;14;0
"1612";"Sal9";"Hpruss";"2003SZ03Hpruss";"26.06.03";15;3;12;0;12;0
"1613";"Sal18";"Hanoma";"2003SZ04Hanoma";"26.06.03";35;1;34;1;33;0,029411765
"1614";"Sal18";"Hleuco";"2003SZ05Hleuco";"26.06.03";28;2;26;0;26;0
"1615";"Sal25";"Halien";"2003SZ06Halien";"26.06.03";310;50;260;16;244;0,061538462
"1616";"Sal9";"Hleuca";"2003SZ07Hleuca";"26.06.03";111;22;89;3;86;0,033707865
"1617";"Sal25";"Heryth";"2003SZ08Heryth";"26.06.03";4;0;4;0;4;0
"1618";"Sal10";"Hpolit";"2003SZ09Hpolit";"14.07.03";211;23;188;11;177;0,058510638
"1619";"Sal10";"Hpurpu";"2003SZ10Hpurpu";"14.07.03";78;3;75;2;73;0,026666667
"1620";"Sal9";"Hpruss";"2003SZ11Hpruss";"14.07.03";208;14;194;14;180;0,072164948
"1621";"Sal9";"Hleuca";"2003SZ12Hleuca";"14.07.03";212;5;207;18;189;0,086956522
"1622";"Sal31";"Hangli";"2003SZ13Hangli";"14.07.03";233;34;199;53;146;0,266331658
"1623";"Sal18";"Hleuco";"2003SZ14Hleuco";"30.07.03";82;2;80;1;79;0,0125
"1624";"Sal10";"Hpolit";"2003SZ15Hpolit";"29.07.03";147;13;134;7;127;0,052238806
"1625";"Sal3";"Hischn";"2003SZ16Hischn";"29.07.03";35;1;34;1;33;0,029411765
"1626";"Sal25";"Halien";"2003SZ17Halien";"30.07.03";15;0;15;0;15;0
"1627";"Sal19";"Hischn";"2003SZ18Hischn";"01.08.03";63;7;56;3;53;0,053571429
"1628";"Sal18";"Hleuco";"2003SZ19Hleuco";"30.07.03";176;20;156;3;153;0,019230769
"1629";"Sal2";"Hspira";"2003SZ20Hspira";"30.07.03";129;26;103;2;101;0,019417476
"1630";"Sal2";"Hspira";"2003SZ21Hspira";"29.07.03";178;28;150;1;149;0,006666667
"1631";"Sal6";"Hplicd";"2003SZ22Hplicd";"01.08.03";111;5;106;2;104;0,018867925
"1632";"Sal10";"Hpurpu";"2003SZ23Hpurpu";"29.07.03";18;0;18;3;15;0,166666667
"1633";"Sal10";"Hpurpu";"2003SZ24Hpurpu";"31.07.03";107;5;102;9;93;0,088235294
"1634";"Sal6";"Hplicd";"2003SZ25Hplicd";"29.07.03";23;1;22;0;22;0
"1635";"Sal2";"Hpscho";"2003SZ26Hpscho";"30.07.03";52;22;30;2;28;0,066666667
"1636";"Sal2";"Hpscho";"2003SZ27Hpscho";"29.07.03";180;4;176;3;173;0,017045455
"1637";"Sal9";"Hpruss";"2003SZ28Hpruss";"12.08.03";242;10;232;3;229;0,012931034
"1638";"Sal18";"Hanoma";"2003SZ29Hanoma";"13.08.03";25;1;24;0;24;0
"1639";"Sal49";"Odolic";"2003SZ30Odolic";"01.08.03";225;4;221;201;20;0,909502262
"1640";"Sal12";"Hoblit";"2003SZ31Hoblit";"14.08.03";12;0;12;3;9;0,25
"1641";"Sal12";"Hoblit";"2003SZ32Hoblit";"15.08.03";3;0;3;0;3;0
"1642";"Sal18";"Hanoma";"2003SZ33Hanoma";"14.08.03";43;12;31;0;31;0
"1643";"Sal31";"Hangli";"2003SZ34Hangli";"21.08.03";242;26;216;5;211;0,023148148
"1644";"Sal9";"Hleuca";"2004SZ01Hleuca";"11.06.04";55;25;30;2;28;0,066666667
"1645";"Sal18";"Hleuco";"2004SZ02Hleuco";"12.06.04";27;12;15;2;13;0,133333333
"1646";"Sal18";"Hanoma";"2004SZ03Hanoma";"12.06.04";47;18;29;0;29;0
"1647";"Sal9";"Hpruss";"2004SZ04Hpruss";"10.06.04";35;14;21;0;21;0
"1648";"Sal9";"Hpruss";"2004SZ05Hpruss";"11.06.04";49;16;33;0;33;0
"1649";"Sal9";"Hleuca";"2004SZ06Hleuca";"10.06.04";108;39;69;1;68;0,014492754
"1650";"Sal9";"Hleuca";"2004SZ07Hleuca";"10.06.04";184;97;87;0;87;0
"1651";"Sal9";"Hpruss";"2004SZ08Hpruss";"10.06.04";44;24;20;0;20;0
"1652";"Sal9";"Hpruss";"2004SZ09Hpruss";"10.06.04";102;44;58;1;57;0,017241379
"1653";"Sal9";"Hleuca";"2004SZ10Hleuca";"10.06.04";180;85;95;0;95;0
"1654";"Sal31";"Hangli";"2004SZ11Hangli";"26.06.04";197;44;153;1;152;0,006535948
"1655";"Sal25";"Heryth";"2004SZ12Heryth";"16.07.04";69;19;50;6;44;0,12
"1656";"Sal25";"Halien";"2004SZ13Halien";"16.07.04";160;66;94;12;82;0,127659574
"1657";"Sal31";"Hangli";"2004SZ14Hangli";"15.07.04";182;16;166;4;162;0,024096386
"1658";"Sal9";"Hleuca";"2004SZ15Hleuca";"28.07.04";33;8;25;0;25;0
"1659";"Sal25";"Halien";"2004SZ16Halien";"28.07.04";34;4;30;0;30;0
"1660";"Sal9";"Obridg";"2004SZ17Obridg";"28.07.04";19;0;19;6;13;0,315789474
"1661";"Sal9";"Hleuca";"2004SZ20Hleuca";"06.08.04";34;12;22;1;21;0,045454545
"1662";"Sal9";"Hpruss";"2004SZ21Hpruss";"06.08.04";48;26;22;5;17;0,227272727
"1663";"Sal16";"Hnudip";"2004SZ22Hnudip";"08.08.04";9;1;8;0;8;0
"1664";"Sal14";"Hacuti";"2004SZ23Hacuti";"08.08.04";13;7;6;1;5;0,166666667
"1665";"Sal16";"Opustu";"2004SZ24Opustu";"08.08.04";13;0;13;7;6;0,538461538
"1666";"Sal18";"Hleuco";"2004SZ25Hleuco";"08.08.04";18;9;9;1;8;0,111111111
"1667";"Sal3";"Hischn";"2004SZ26Hischn";"08.08.04";38;19;19;0;19;0
"1668";"Sal21";"Hcarin";"2004SZ27Hcarin";"12.08.04";19;7;12;1;11;0,083333333
"1669";"Sal14";"Hacuti";"2004SZ28Hacuti";"12.08.04";192;94;98;5;93;0,051020408
"1670";"Sal14";"Hplicl";"2004SZ29Hplicl";"12.08.04";17;6;11;1;10;0,090909091
"1671";"Sal50";"Opolar";"2004SZ30Opolar";"12.08.04";9;0;9;7;2;0,777777778
"1672";"Sal5";"Ohasta";"2004SZ31Ohasta";"13.08.04";31;0;31;21;10;0,677419355
"1673";"Sal14";"Elappo";"2004SZ32Elappo";"12.08.04";35;0;35;15;20;0,428571429
"1674";"Sal5";"Ehasta";"2004SZ35Ehasta";"13.08.04";24;0;24;5;19;0,208333333
"1675";"Sal17";"Hplicg";"2004SZ36Hplicg";"13.08.04";168;53;115;17;98;0,147826087
"1676";"Sal17";"Hplicg";"2004SZ37Hplicg";"13.08.04";98;10;88;4;84;0,045454545
"1677";"Sal17";"Onival";"2004SZ38Onival";"13.08.04";17;0;17;1;16;0,058823529
"1678";"Sal17";"Hplicg";"2004SZ39Hplicg";"14.08.04";12;2;10;1;9;0,1
"1679";"Sal3";"Ovaria";"2004SZ40Ovaria";"16.08.04";46;0;46;29;17;0,630434783
"1680";"Sal17";"Hplicg";"2004SZ41Hplicg";"17.08.04";32;13;19;3;16;0,157894737
"1681";"Sal27";"Elanat";"2004SZ42Elanat";"18.08.04";2;0;2;0;2;0
"1682";"Sal17";"Eboreo";"2004SZ43Eboreo";"18.08.04";35;0;35;6;29;0,171428571
"1683";"Sal3";"Emyrsi";"2004SZ44Emyrsi";"19.08.04";24;0;24;16;8;0,666666667
"1684";"Sal3";"Ovaria";"2004SZ45Ovaria";"19.08.04";16;1;15;2;13;0,133333333
"1685";"Sal3";"Onigri";"2004SZ46Onigri";"19.08.04";7;3;4;3;1;0,75
"1686";"Sal3";"Hischn";"2004SZ47Hischn";"19.08.04";13;5;8;0;8;0
"1687";"Sal16";"Hnudip";"2004SZ48Hnudip";"19.08.04";15;5;10;0;10;0
"1688";"Sal21";"Hcarin";"2004SZ49Hcarin";"19.08.04";18;6;12;0;12;0
"1689";"Sal3";"Hischn";"2004SZ50Hischn";"19.08.04";10;1;9;0;9;0
"1690";"Sal25";"Halien";"2004SZ51Halien";"19.08.04";66;11;55;2;53;0,036363636
"1691";"Sal25";"Halien";"2004SZ52Halien";"20.08.04";75;12;63;3;60;0,047619048
"1692";"Sal25";"Heryth";"2004SZ53Heryth";"20.08.04";103;20;83;1;82;0,012048193
"1693";"Sal25";"Obella";"2004SZ54Obella";"20.08.04";7;0;7;5;2;0,714285714
"1694";"Sal3";"Hischn";"2004SZ55Hischn";"21.08.04";38;18;20;3;17;0,15
"1695";"Sal3";"Hischn";"2004SZ56Hischn";"22.08.04";86;14;72;0;72;0
"1696";"Sal15";"Omyrsi";"2004SZ57Omyrsi";"22.08.04";78;4;74;69;5;0,932432432
"1697";"Sal15";"Esmyrs";"2004SZ59Esmyrs";"22.08.04";4;0;4;0;4;0
"1698";"Sal14";"Hacuti";"2004SZ60Hacuti";"22.08.04";12;4;8;3;5;0,375
"1699";"Sal16";"Hplicp";"2004SZ61Hplicp";"22.08.04";15;5;10;1;9;0,1
"1700";"Sal16";"Odolic";"2004SZ62Odolic";"22.08.04";16;0;16;12;4;0,75
"1701";"Sal16";"Oarcti";"2004SZ63Oarcti";"22.08.04";38;1;37;31;6;0,837837838
"1702";"Sal16";"Ephyli";"2004SZ64Ephyli";"22.08.04";12;0;12;2;10;0,166666667
"1703";"Sal17";"Eboreo";"2004SZ67Eboreo";"23.08.04";16;0;16;5;11;0,3125
"1704";"Sal14";"Osamol";"2004SZ69Osamol";"24.08.04";32;2;30;19;11;0,633333333
"1705";"Sal14";"Olappo";"2004SZ70Olappo";"24.08.04";21;1;20;9;11;0,45
"1706";"Sal14";"Elappo";"2004SZ71Elappo";"24.08.04";61;0;61;11;50;0,180327869
"1707";"Sal16";"Hplicp";"2004SZ72Hplicp";"24.08.04";6;1;5;1;4;0,2
"1708";"Sal27";"Oglabr";"2004SZ73Oglabr";"24.08.04";45;4;41;15;26;0,365853659
"1709";"Sal27";"Elanat";"2004SZ74Elanat";"24.08.04";30;0;30;9;21;0,3
"1710";"Sal35";"Eweiff";"2004SZ75Eweiff";"26.08.04";27;0;27;11;16;0,407407407
"1711";"Sal35";"Ocolla";"2004SZ76Ocolla";"26.08.04";5;0;5;1;4;0,2
"1712";"Sal25";"Halien";"2004SZ78Halien";"26.08.04";18;9;9;3;6;0,333333333
"1713";"Sal25";"Obella";"2004SZ79Obella";"26.08.04";45;0;45;5;40;0,111111111
"1714";"Sal14";"Elappo";"2004SZ80Elappo";"26.08.04";25;0;25;14;11;0,56
"1715";"Sal10";"Ovesic";"200502A1-V1Ovesic";"24.06.05";61;0;61;2;59;0,032786885
"1716";"Sal10";"Ovimin";"200502A-GOvimin";"24.06.05";27;0;27;2;25;0,074074074
"1717";"Sal9";"Obridg";"200502I-PObridg";"24.06.05";32;4;28;4;24;0,142857143
"1718";"Sal9";"Opedun";"200502R-UOpedun";"24.06.05";13;0;13;4;9;0,307692308
"1719";"Sal10";"Oviril";"200504G-V1Oviril";"11.06.05";246;0;246;60;186;0,243902439
"1720";"Sal10";"Oviril";"200505A-GOviril";"15.06.05";51;0;51;22;29;0,431372549
"1721";"Sal10";"Oviril";"200505G1-R1+9A-V1Oviril";"10.06.05";366;0;366;122;244;0,333333333
"1722";"Sal10";"Oviril";"200505I-E1Oviril";"12.06.05";135;0;135;45;90;0,333333333
"1723";"Sal12";"Oproxi";"200510A-N1Oproxi";"20.07.05";162;0;162;70;92;0,432098765
"1724";"Sal21";"Opprox";"200510P1-V1Opprox";"19.07.05";26;0;26;20;6;0,769230769
"1725";"Sal21";"Opprox";"200511A-JOpprox";"24.07.05";41;0;41;22;19;0,536585366
"1726";"Sal10";"Ovimin";"200514A-EOvimin";"25.08.05";22;1;21;4;17;0,19047619
"1727";"Sal10";"Ovesic";"200514F-LOvesic";"25.08.05";28;0;28;7;21;0,25
"1728";"Sal9";"Eciner";"200516A-Q1Eciner";"22.04.06";75;13;62;52;10;0,838709677
"1729";"Sal25";"Eaurit";"200517A1-O1Eaurit";"24.04.06";31;0;31;24;7;0,774193548
"1730";"Sal25";"Eaurit";"200517A-LEaurit";"23.04.06";16;0;16;12;4;0,75
"1731";"Sal10";"Epurpu";"200518A-ZEpurpu";"10.04.06";26;0;26;10;16;0,384615385
"1732";"Sal13";"Eweiff";"200563A-64FEweiff";"28.11.05";216;0;216;163;53;0,75462963
"1733";"Sal31";"Hangli";"2005SZ06Hangli";"15.06.05";48;2;46;0;46;0
"1734";"Sal31";"Hangli";"2005SZ07Hangli";"14.06.05";199;1;198;0;198;0
"1735";"Sal10";"Hpurpu";"2005SZ08Hpurpu";"17.06.05";4;1;3;0;3;0
"1736";"Sal10";"Hpolit";"2005SZ09Hpolit";"14.06.05";48;11;37;1;36;0,027027027
"1737";"Sal10";"Hpurpu";"2005SZ10Hpurpu";"18.06.05";29;4;25;2;23;0,08
"1738";"Sal10";"Hpolit";"2005SZ11Hpolit";"10.06.05";62;14;48;0;48;0
"1739";"Sal10";"Hpolit";"2005SZ12Hpolit";"18.06.05";55;9;46;1;45;0,02173913
"1740";"Sal10";"Hpolit";"2005SZ13Hpolit";"15.06.05";32;5;27;0;27;0
"1741";"Sal10";"Hpurpu";"2005SZ14Hpurpu";"14.06.05";23;12;11;1;10;0,090909091
"1742";"Sal9";"Hleuca";"2005SZ15Hleuca";"11.06.05";109;22;87;3;84;0,034482759
"1743";"Sal10";"Hpolit";"2005SZ16Hpolit";"17.06.05";40;7;33;1;32;0,03030303
"1744";"Sal9";"Hpruss";"2005SZ17Hpruss";"17.06.05";154;53;101;2;99;0,01980198
"1745";"Sal10";"Hpurpu";"2005SZ18Hpurpu";"10.06.05";13;7;6;0;6;0
"1746";"Sal9";"Hpruss";"2005SZ19Hpruss";"11.06.05";33;0;33;2;31;0,060606061
"1747";"Sal9";"Hpruss";"2005SZ20Hpruss";"15.06.05";52;27;25;1;24;0,04
"1748";"Sal9";"Hleuca";"2005SZ21Hleuca";"15.06.05";62;16;46;0;46;0
"1749";"Sal9";"Hleuca";"2005SZ22Hleuca";"14.06.05";220;87;133;5;128;0,037593985
"1750";"Sal9";"Hleuca";"2005SZ23Hleuca";"17.06.05";111;43;68;2;66;0,029411765
"1751";"Sal9";"Hleuca";"2005SZ24Hleuca";"11.06.05";42;26;16;0;16;0
"1752";"Sal9";"Hleuca";"2005SZ25Hleuca";"17.06.05";99;37;62;1;61;0,016129032
"1753";"Sal25";"Halien";"2005SZ26Halien";"18.06.05";39;4;35;0;35;0
"1754";"Sal9";"Hpruss";"2005SZ27Hpruss";"17.06.05";68;21;47;0;47;0
"1755";"Sal25";"Heryth";"2005SZ28Heryth";"18.06.05";86;6;80;0;80;0
"1756";"Sal51";"Hpruss";"2005SZ29Hpruss";"14.06.05";29;19;10;0;10;0
"1757";"Sal18";"Hleuco";"2005SZ30Hleuco";"14.06.05";8;7;1;0;1;0
"1758";"Sal10";"Hpurpu";"2005SZ31Hpurpu";"15.06.05";5;2;3;0;3;0
"1759";"Sal9";"Hleuca";"2005SZ32Hleuca";"24.06.05";65;11;54;0;54;0
"1760";"Sal9";"Hleuca";"2005SZ33Hleuca";"23.06.05";18;3;15;2;13;0,133333333
"1761";"Sal25";"Halien";"2005SZ34Halien";"23.06.05";10;4;6;0;6;0
"1762";"Sal25";"Heryth";"2005SZ35Heryth";"23.06.05";64;17;47;0;47;0
"1763";"Sal9";"Hleuca";"2005SZ36Hleuca";"24.06.05";31;6;25;2;23;0,08
"1764";"Sal9";"Hpruss";"2005SZ37Hpruss";"24.06.05";32;7;25;0;25;0
"1765";"Sal9";"Hpruss";"2005SZ38Hpruss";"25.06.05";20;13;7;0;7;0
"1766";"Sal9";"Hleuca";"2005SZ39Hleuca";"25.06.05";5;3;2;0;2;0
"1767";"Sal9";"Hpruss";"2005SZ40Hpruss";"24.06.05";15;7;8;0;8;0
"1768";"Sal10";"Hpurpu";"2005SZ41Hpurpu";"05.07.05";101;48;53;44;9;0,830188679
"1769";"Sal18";"Hleuco";"2005SZ42Hleuco";"19.07.05";17;4;13;1;12;0,076923077
"1770";"Sal9";"Hpruss";"2005SZ43Hpruss";"28.07.05";15;7;8;0;8;0
"1771";"Sal25";"Heryth";"2005SZ44Heryth";"24.07.05";44;28;16;1;15;0,0625
"1772";"Sal18";"Hanoma";"2005SZ45Hanoma";"29.07.05";15;11;4;0;4;0
"1773";"Sal9";"Hpruss";"2005SZ46Hpruss";"19.07.05";18;9;9;0;9;0
"1774";"Sal18";"Hleuco";"2005SZ47Hleuco";"29.07.05";32;27;5;0;5;0
"1775";"Sal18";"Hanoma";"2005SZ48Hanoma";"20.07.05";7;5;2;0;2;0
"1776";"Sal9";"Hpruss";"2005SZ49Hpruss";"15.07.05";50;8;42;0;42;0
"1777";"Sal9";"Hpruss";"2005SZ50Hpruss";"20.07.05";100;40;60;3;57;0,05
"1778";"Sal9";"Hleuca";"2005SZ51Hleuca";"15.07.05";21;7;14;1;13;0,071428571
"1779";"Sal25";"Heryth";"2005SZ52Heryth";"18.07.05";45;6;39;0;39;0
"1780";"Sal9";"Hleuca";"2005SZ53Hleuca";"19.07.05";31;2;29;0;29;0
"1781";"Sal18";"Hleuco";"2005SZ54Hleuco";"18.07.05";36;6;30;4;26;0,133333333
"1782";"Sal9";"Hpruss";"2005SZ55Hpruss";"15.07.05";23;7;16;0;16;0
"1783";"Sal25";"Heryth";"2005SZ56Heryth";"20.07.05";85;57;28;4;24;0,142857143
"1784";"Sal9";"Hleuca";"2005SZ57Hleuca";"16.07.05";35;1;34;0;34;0
"1785";"Sal18";"Hanoma";"2005SZ58Hanoma";"19.07.05";41;6;35;0;35;0
"1786";"Sal18";"Hleuco";"2005SZ59Hleuco";"15.07.05";93;12;81;0;81;0
"1787";"Sal9";"Hpruss";"2005SZ60Hpruss";"18.07.05";97;7;90;10;80;0,111111111
"1788";"Sal18";"Hanoma";"2005SZ61Hanoma";"24.07.05";70;19;51;0;51;0
"1789";"Sal9";"Hpruss";"2005SZ62Hpruss";"21.07.05";105;44;61;5;56;0,081967213
"1790";"Sal25";"Heryth";"2005SZ63Heryth";"22.07.05";37;13;24;4;20;0,166666667
"1791";"Sal9";"Hpruss";"2005SZ64Hpruss";"23.07.05";100;12;88;16;72;0,181818182
"1792";"Sal18";"Hanoma";"2005SZ65Hanoma";"18.07.05";129;47;82;0;82;0
"1793";"Sal18";"Hanoma";"2005SZ66Hanoma";"15.07.05";42;17;25;0;25;0
"1794";"Sal9";"Hleuca";"2005SZ67Hleuca";"18.07.05";11;5;6;0;6;0
"1795";"Sal52";"Hoblit";"2005SZ68Hoblit";"19.07.05";43;13;30;3;27;0,1
"1796";"Sal9";"Hpruss";"2005SZ69Hpruss";"22.07.05";108;13;95;0;95;0
"1797";"Sal9";"Hpruss";"2005SZ70Hpruss";"17.07.05";110;12;98;0;98;0
"1798";"Sal31";"Hangli";"2005SZ71Hangli";"22.07.05";104;3;101;0;101;0
"1799";"Sal9";"Hleuca";"2005SZ72Hleuca";"22.07.05";118;20;98;0;98;0
"1800";"Sal9";"Hleuca";"2005SZ73Hleuca";"23.07.05";14;0;14;0;14;0
"1801";"Sal9";"Hleuca";"2005SZ74Hleuca";"29.07.05";29;6;23;0;23;0
"1802";"Sal9";"Hleuca";"2005SZ75Hleuca";"17.07.05";71;9;62;2;60;0,032258065
"1803";"Sal9";"Hleuca";"2005SZ76Hleuca";"24.07.05";72;13;59;9;50;0,152542373
"1804";"Sal31";"Hangli";"2005SZ77Hangli";"17.07.05";113;5;108;1;107;0,009259259
"1805";"Sal9";"Hleuca";"2005SZ78Hleuca";"20.07.05";70;38;32;0;32;0
"1806";"Sal9";"Hleuca";"2005SZ79Hleuca";"20.07.05";59;6;53;9;44;0,169811321
"1807";"Sal25";"Halien";"2005SZ80Halien";"22.07.05";18;0;18;2;16;0,111111111
"1808";"Sal9";"Hleuca";"2005SZ81Hleuca";"21.07.05";34;10;24;4;20;0,166666667
"1809";"Sal9";"Hpruss";"2005SZ82Hpruss";"20.07.05";181;10;171;0;171;0
"1810";"Sal10";"Hpolit";"2005SZ83Hpolit";"26.07.05";201;13;188;0;188;0
"1811";"Sal10";"Hpolit";"2005SZ84Hpolit";"25.07.05";82;18;64;0;64;0
"1812";"Sal10";"Hpurpu";"2005SZ85Hpurpu";"25.07.05";14;6;8;0;8;0
"1813";"Sal9";"Hleuca";"2005SZ86Hleuca";"22.07.05";528;286;242;77;165;0,318181818
"1814";"Sal6";"Oadaph";"200609A-K1Oadaph";"13.08.06";110;0;110;38;72;0,345454545
"1815";"Sal48";"Oaacut";"200610A-ZOaacut";"07.08.06";81;5;76;4;72;0,052631579
"1816";"Sal10";"Ovimin";"200611A-S1Ovimin";"07.08.06";133;2;131;3;128;0,022900763
"1817";"Sal12";"Etesta";"200612A-G1Etesta";"09.08.06";131;7;124;33;91;0,266129032
"1818";"Sal13";"Eweiff";"200613A-LEweiff";"30.11.06";25;0;25;19;6;0,76
"1819";"Sal13";"Eweiff";"200614A-PEweiff";"28.11.06";32;0;32;28;4;0,875
"1820";"Sal13";"Eweiff";"200615A-16KEweiff";"27.11.06";177;0;177;151;26;0,853107345
"1821";"Sal25";"Heryth";"2006SZ01Heryth";"02.07.06";55;16;39;0;39;0
"1822";"Sal18";"Hleuco";"2006SZ02Hleuco";"03.07.06";69;19;50;0;50;0
"1823";"Sal9";"Hpruss";"2006SZ03Hpruss";"03.07.06";21;13;8;0;8;0
"1824";"Sal11";"Hoblit";"2006SZ04Hoblit";"03.07.06";25;6;19;1;18;0,052631579
"1825";"Sal11";"Hoblit";"2006SZ05Hoblit";"04.07.06";7;2;5;2;3;0,4
"1826";"Sal10";"Hpurpu";"2006SZ06Hpurpu";"04.07.06";4;0;4;0;4;0
"1827";"Sal10";"Hpolit";"2006SZ08Hpolit";"04.07.06";40;10;30;4;26;0,133333333
"1828";"Sal10";"Hpolit";"2006SZ10Hpolit";"03.07.06";102;29;73;0;73;0
"1829";"Sal18";"Hanoma";"2006SZ11Hanoma";"03.07.06";26;9;17;0;17;0
"1830";"Sal11";"Hoblit";"2006SZ12Hoblit";"02.07.06";14;3;11;5;6;0,454545455
"1831";"Sal10";"Hpolit";"2006SZ13Hpolit";"02.07.06";74;26;48;1;47;0,020833333
"1832";"Sal9";"Hpruss";"2006SZ14Hpruss";"03.07.06";119;22;97;0;97;0
"1833";"Sal10";"Hpurpu";"2006SZ15Hpurpu";"04.07.06";2;1;1;0;1;0
"1834";"Sal10";"Hpurpu";"2006SZ16Hpurpu";"02.07.06";7;1;6;0;6;0
"1835";"Sal9";"Hleuca";"2006SZ17Hleuca";"04.07.06";55;48;7;1;6;0,142857143
"1836";"Sal9";"Hpruss";"2006SZ18Hpruss";"04.07.06";128;25;103;0;103;0
"1837";"Sal25";"Halien";"2006SZ19Halien";"02.07.06";68;11;57;0;57;0
"1838";"Sal9";"Hleuca";"2006SZ20Hleuca";"03.07.06";61;27;34;2;32;0,058823529
"1839";"Sal9";"Hleuca";"2006SZ21Hleuca";"04.07.06";63;30;33;5;28;0,151515152
"1840";"Sal10";"Hpolit";"2006SZ22Hpolit";"15.07.06";209;21;188;0;188;0
"1841";"Sal10";"Hpurpu";"2006SZ23Hpurpu";"15.07.06";56;14;42;11;31;0,261904762
"1842";"Sal10";"Hpurpu";"2006SZ24Hpurpu";"03.08.06";59;12;47;8;39;0,170212766
"1843";"Sal10";"Hpolit";"2006SZ25Hpolit";"03.08.06";22;3;19;2;17;0,105263158
"1844";"Sal18";"Hanoma";"2006SZ26Hanoma";"03.08.06";39;6;33;3;30;0,090909091
"1845";"Sal18";"Hanoma";"2006SZ27Hanoma";"06.08.06";57;6;51;1;50;0,019607843
"1846";"Sal18";"Hleuco";"2006SZ28Hleuco";"06.08.06";31;0;31;0;31;0
"1847";"Sal9";"Hleuca";"2006SZ29Hleuca";"06.08.06";73;20;53;5;48;0,094339623
"1848";"Sal9";"Hleuca";"2006SZ30Hleuca";"09.08.06";81;24;57;5;52;0,087719298
"1849";"Sal12";"Hoblit";"2006SZ31Hoblit";"09.08.06";2;0;2;0;2;0
"1850";"Sal31";"Hangli";"2006SZ32Hangli";"05.08.06";102;15;87;14;73;0,16091954
"1851";"Sal31";"Hangli";"2006SZ33Hangli";"07.08.06";62;4;58;10;48;0,172413793
"1852";"Sal9";"Hleuca";"2006SZ34Hleuca";"05.08.06";44;10;34;2;32;0,058823529
"1853";"Sal18";"Hleuco";"2006SZ35Hleuco";"09.08.06";2;0;2;0;2;0
"1854";"Sal9";"Hpruss";"2006SZ36Hpruss";"09.08.06";20;1;19;4;15;0,210526316
"1855";"Sal9";"Hpruss";"2006SZ37Hpruss";"05.08.06";55;6;49;0;49;0
"1856";"Sal18";"Hanoma";"2006SZ38Hanoma";"09.08.06";76;9;67;6;61;0,089552239
"1857";"Sal25";"Heryth";"2006SZ39Heryth";"09.08.06";26;9;17;3;14;0,176470588
"1858";"Sal9";"Hpruss";"2006SZ40Hpruss";"09.08.06";21;7;14;1;13;0,071428571
"1859";"Sal9";"Hpruss";"2006SZ41Hpruss";"13.08.06";61;19;42;10;32;0,238095238
"1860";"Sal12";"Hoblit";"2006SZ42Hoblit";"10.08.06";9;3;6;1;5;0,166666667
"1861";"Sal18";"Hanoma";"2006SZ43Hanoma";"16.08.06";81;11;70;2;68;0,028571429
"1862";"Sal18";"Hanoma";"2006SZ44Hanoma";"15.08.06";99;22;77;10;67;0,12987013
"1863";"Sal25";"Halien";"2006SZ45Halien";"09.08.06";99;11;88;10;78;0,113636364
"1864";"Sal9";"Hleuca";"2006SZ46Hleuca";"09.08.06";33;2;31;2;29;0,064516129
"1865";"Sal3";"Hischn";"2006SZ47Hischn";"13.08.06";26;13;13;2;11;0,153846154
"1866";"Sal12";"Hoblit";"2006SZ48Hoblit";"14.08.06";2;1;1;0;1;0
"1867";"Sal9";"Hpruss";"2006SZ49Hpruss";"12.08.06";62;23;39;15;24;0,384615385
"1868";"Sal31";"Hangli";"2006SZ50Hangli";"10.08.06";56;2;54;4;50;0,074074074
"1869";"Sal18";"Hanoma";"2006SZ51Hanoma";"13.08.06";90;22;68;7;61;0,102941176
"1870";"Sal9";"Hleuca";"2006SZ52Hleuca";"14.08.06";28;1;27;1;26;0,037037037
"1871";"Sal9";"Hleuca";"2006SZ53Hleuca";"13.08.06";25;6;19;5;14;0,263157895
"1872";"Sal18";"Hanoma";"2006SZ54Hanoma";"11.08.06";84;16;68;10;58;0,147058824
"1873";"Sal13";"Eweiff";"200733A-FEweiff";"28.11.07";12;0;12;2;10;0,166666667
"1874";"Sal13";"Eweiff";"200733H-OEweiff";"26.11.07";16;1;15;8;7;0,533333333
"1875";"Sal13";"Eweiff";"200733Q-D1Eweiff";"30.11.07";28;0;28;25;3;0,892857143
"1876";"Sal9";"Hleuca";"2007SZ02Hleuca";"19.06.07";20;8;12;0;12;0
"1877";"Sal9";"Hleuca";"2007SZ03Hleuca";"15.06.07";24;4;20;0;20;0
"1878";"Sal9";"Hleuca";"2007SZ04Hleuca";"24.06.07";49;11;38;3;35;0,078947368
"1879";"Sal25";"Halien";"2007SZ05Halien";"24.06.07";41;8;33;4;29;0,121212121
"1880";"Sal25";"Heryth";"2007SZ06Heryth";"24.06.07";82;29;53;2;51;0,037735849
"1881";"Sal9";"Hpruss";"2007SZ07Hpruss";"19.06.07";67;11;56;0;56;0
"1882";"Sal9";"Hpruss";"2007SZ08aHpruss";"24.06.07";65;7;58;2;56;0,034482759
"1883";"Sal9";"Hspecc";"2007SZ08bHspecc";"24.06.07";17;1;16;0;16;0
"1884";"Sal18";"Hleuco";"2007SZ09Hleuco";"24.06.07";106;28;78;4;74;0,051282051
"1885";"Sal9";"Hpruss";"2007SZ10Hpruss";"15.06.07";99;23;76;4;72;0,052631579
"1886";"Sal18";"Hanoma";"2007SZ11Hanoma";"24.06.07";30;7;23;0;23;0
"1887";"Sal31";"Hangli";"2007SZ12Hangli";"15.06.07";10;0;10;0;10;0
"1888";"Sal18";"Hleuco";"2007SZ13aHleuco";"30.06.07";77;25;52;2;50;0,038461538
"1889";"Sal18";"Hleuco";"2007SZ13bHleuco";"30.06.07";2;0;2;0;2;0
"1890";"Sal18";"Hleuco";"2007SZ14Hleuco";"30.06.07";10;3;7;0;7;0
"1891";"Sal9";"Hpruss";"2007SZ15Hpruss";"30.06.07";25;5;20;0;20;0
"1892";"Sal9";"Hleuca";"2007SZ16Hleuca";"03.07.07";5;1;4;0;4;0
"1893";"Sal9";"Hspecc";"2007SZ17Hspecc";"03.07.07";38;3;35;1;34;0,028571429
"1894";"Sal11";"Hoblit";"2007SZ18Hoblit";"03.07.07";10;2;8;2;6;0,25
"1895";"Sal9";"Hspecc";"2007SZ19aHspecc";"03.07.07";41;7;34;0;34;0
"1896";"Sal9";"Hpruss";"2007SZ20Hpruss";"03.07.07";112;31;81;1;80;0,012345679
"1897";"Sal18";"Hanoma";"2007SZ21Hanoma";"03.07.07";45;1;44;0;44;0
"1898";"Sal9";"Hleuca";"2007SZ22Hleuca";"03.07.07";39;12;27;1;26;0,037037037
"1899";"Sal10";"Hpolit";"2007SZ23aHpolit";"03.07.07";66;8;58;1;57;0,017241379
"1900";"Sal9";"Hpruss";"2007SZ24aHpruss";"03.07.07";79;15;64;1;63;0,015625
"1901";"Sal18";"Hleuco";"2007SZ25aHleuco";"03.07.07";104;9;95;5;90;0,052631579
"1902";"Sal18";"Hleuco";"2007SZ26Hleuco";"04.07.07";19;5;14;0;14;0
"1903";"Sal10";"Hpolit";"2007SZ27Hpolit";"04.07.07";28;6;22;0;22;0
"1904";"Sal9";"Hleuca";"2007SZ28Hleuca";"04.07.07";89;23;66;12;54;0,181818182
"1905";"Sal18";"Hanoma";"2007SZ29Hanoma";"04.07.07";107;12;95;0;95;0
"1906";"Sal18";"Hleuco";"2007SZ30Hleuco";"04.07.07";67;2;65;2;63;0,030769231
"1907";"Sal9";"Hpruss";"2007SZ31Hpruss";"04.07.07";31;7;24;3;21;0,125
"1908";"Sal18";"Hleuco";"2007SZ32Hleuco";"05.07.07";90;12;78;3;75;0,038461538
"1909";"Sal18";"Hanoma";"2007SZ33Hanoma";"05.07.07";28;4;24;0;24;0
"1910";"Sal18";"Hleuco";"2007SZ34Hleuco";"06.07.07";24;3;21;0;21;0
"1911";"Sal18";"Hanoma";"2007SZ35Hanoma";"06.07.07";123;25;98;0;98;0
"1912";"Sal11";"Hoblit";"2007SZ36aHoblit";"30.07.07";42;2;40;0;40;0
"1913";"Sal21";"Hcarin";"2007SZ37Hcarin";"31.07.07";145;29;116;28;88;0,24137931
"1914";"Sal2";"Hspira";"2007SZ38Hspira";"31.07.07";27;10;17;4;13;0,235294118
"1915";"Sal8";"Hplicg";"2007SZ39Hplicg";"31.07.07";73;20;53;26;27;0,490566038
"1916";"Sal5";"Htuber";"2007SZ40Htuber";"31.07.07";4;0;4;0;4;0
"1917";"Sal2";"Hpscho";"2007SZ41Hpscho";"01.08.07";65;8;57;0;57;0
"1918";"Sal2";"Hspira";"2007SZ42Hspira";"01.08.07";28;8;20;2;18;0,1
"1919";"Sal2";"Hpscho";"2007SZ43Hpscho";"01.08.07";1;0;1;0;1;0
"1920";"Sal2";"Hspira";"2007SZ44Hspira";"01.08.07";57;9;48;1;47;0,020833333
"1921";"Sal2";"Hspira";"2007SZ45Hspira";"02.08.07";8;2;6;1;5;0,166666667
"1922";"Sal2";"Hspira";"2007SZ46Hspira";"02.08.07";68;13;55;15;40;0,272727273
"1923";"Sal8";"Hplicg";"2007SZ47Hplicg";"02.08.07";40;2;38;9;29;0,236842105
"1924";"Sal12";"Oproxi";"200801A-YOproxi";"30.06.08";51;0;51;27;24;0,529411765
"1925";"Sal12";"Oproxi";"200802A-WOproxi";"20.07.08";68;1;67;42;25;0,626865672
"1926";"Sal18";"Obridg";"200803A-OObridg";"09.08.08";61;3;58;50;8;0,862068966
"1927";"Sal3";"Ovaria";"200803Q-V1Ovaria";"15.08.08";92;2;90;29;61;0,322222222
"1928";"Sal5";"Ohasta";"200804A1-R1Ohasta";"09.08.08";55;0;55;33;22;0,6
"1929";"Sal16";"Opustu";"200804A-WOpustu";"18.08.08";46;0;46;6;40;0,130434783
"1930";"Sal3";"Emyrsi";"200805A-PEmyrsi";"16.08.08";47;5;42;8;34;0,19047619
"1931";"Sal14";"Olappo";"200805K1-T1Olappo";"17.08.08";20;0;20;0;20;0
"1932";"Sal18";"Evenus";"200805R-I1Evenus";"13.08.08";56;0;56;9;47;0,160714286
"1933";"Sal14";"Elappc";"200806A-WElappc";"15.08.08";91;0;91;27;64;0,296703297
"1934";"Sal13";"Eweiff";"200815A-16KEweiff";"30.11.08";118;0;118;60;58;0,508474576
"1935";"Sal13";"Eweiff";"200816M-VEweiff";"25.11.08";20;0;20;10;10;0,5
"1936";"Sal9";"Hpruss";"2008SZ01Hpruss";"30.06.08";40;6;34;0;34;0
"1937";"Sal9";"Hleuca";"2008SZ02Hleuca";"30.06.08";7;1;6;0;6;0
"1938";"Sal18";"Hanoma";"2008SZ03Hanoma";"30.06.08";52;10;42;0;42;0
"1939";"Sal18";"Hleuco";"2008SZ04Hleuco";"30.06.08";14;2;12;0;12;0
"1940";"Sal9";"Hpruss";"2008SZ05Hpruss";"12.07.08";65;11;54;5;49;0,092592593
"1941";"Sal9";"Hleuca";"2008SZ06aHleuca";"12.07.08";63;19;44;2;42;0,045454545
"1942";"Sal25";"Halien";"2008SZ07Halien";"12.07.08";41;8;33;2;31;0,060606061
"1943";"Sal25";"Heryth";"2008SZ08Heryth";"12.07.08";42;8;34;1;33;0,029411765
"1944";"Sal17";"Hplicg";"2008SZ09Hplicg";"12.08.08";213;29;184;22;162;0,119565217
"1945";"Sal16";"Hnudip";"2008SZ10Hnudip";"08.08.08";5;2;3;1;2;0,333333333
"1946";"Sal16";"Hnudip";"2008SZ11Hnudip";"05.08.08";3;0;3;0;3;0
"1947";"Sal18";"Hanoma";"2008SZ12Hanoma";"09.08.08";3;0;3;0;3;0
"1948";"Sal3";"Hischn";"2008SZ13Hischn";"08.08.08";12;9;3;0;3;0
"1949";"Sal17";"Hsglau";"2008SZ14Hsglau";"09.08.08";2;0;2;0;2;0
"1950";"Sal17";"Hplicg";"2008SZ15Hplicg";"10.08.08";13;4;9;0;9;0
"1951";"Sal14";"Hacuti";"2008SZ16Hacuti";"08.08.08";12;7;5;0;5;0
"1952";"Sal17";"Hplicg";"2008SZ17Hplicg";"08.08.08";10;3;7;4;3;0,571428571
"1953";"Sal17";"Hsglau";"2008SZ18Hsglau";"12.08.08";42;10;32;4;28;0,125
"1954";"Sal17";"Hplicg";"2008SZ19Hplicg";"08.08.08";21;9;12;4;8;0,333333333
"1955";"Sal17";"Hsglau";"2008SZ20Hsglau";"17.08.08";7;0;7;0;7;0
"1956";"Sal17";"Hplicg";"2008SZ21Hplicg";"19.08.08";8;3;5;0;5;0
"1957";"Sal14";"Hacuti";"2008SZ22Hacuti";"12.08.08";17;5;12;0;12;0
"1958";"Sal3";"Hischn";"2008SZ23Hischn";"05.08.08";21;3;18;2;16;0,111111111
"1959";"Sal3";"Hischn";"2008SZ24Hischn";"10.08.08";31;15;16;0;16;0
"1960";"Sal17";"Hplicg";"2008SZ25Hplicg";"09.08.08";48;24;24;14;10;0,583333333
"1961";"Sal25";"Halien";"2008SZ26Halien";"18.08.08";130;13;117;13;104;0,111111111
"1962";"Sal25";"Heryth";"2008SZ27Heryth";"19.08.08";90;16;74;0;74;0
"1963";"Sal14";"Hplicl";"2008SZ28Hplicl";"19.08.08";85;6;79;3;76;0,037974684
"1964";"Sal14";"Hplicl";"2008SZ29Hplicl";"12.08.08";212;36;176;21;155;0,119318182
"1965";"Sal25";"Halien";"2008SZ30Halien";"19.08.08";82;10;72;9;63;0,125
"1966";"Sal16";"Hnudip";"2008SZ31Hnudip";"18.08.08";98;12;86;1;85;0,011627907
"1967";"Sal17";"Hplicg";"2008SZ32Hplicg";"17.08.08";33;4;29;0;29;0
"1968";"Sal3";"Hischn";"2008SZ33Hischn";"14.08.08";26;0;26;0;26;0
"1969";"Sal3";"Hischn";"2008SZ34Hischn";"12.08.08";11;0;11;0;11;0
"1970";"Sal18";"Hleuco";"2008SZ35Hleuco";"18.08.08";34;1;33;0;33;0
"1971";"Sal14";"Hplicl";"2008SZ36Hplicl";"18.08.08";93;10;83;25;58;0,301204819
"1972";"Sal10";"Oviril";"200901A-JOviril";"08.06.09";39;3;36;23;13;0,638888889
"1973";"Sal13";"Eweiff";"200942A-42L1Eweiff";"25.11.09";114;6;108;51;57;0,472222222
"1974";"Sal13";"Eweiff";"200944A-45LEweiff";"30.11.09";178;2;176;127;49;0,721590909
"1975";"Sal18";"Hanoma";"2009SZ01Hanoma";"11.06.09";29;17;12;0;12;0
"1976";"Sal18";"Hleuco";"2009SZ02Hleuco";"11.06.09";78;27;51;0;51;0
"1977";"Sal18";"Hleuco";"2009SZ03Hleuco";"09.06.09";16;7;9;0;9;0
"1978";"Sal18";"Hanoma";"2009SZ04Hanoma";"09.06.09";40;16;24;0;24;0
"1979";"Sal18";"Hleuco";"2009SZ05Hleuco";"08.06.09";24;17;7;0;7;0
"1980";"Sal18";"Hanoma";"2009SZ06Hanoma";"08.06.09";48;29;19;4;15;0,210526316
"1981";"Sal18";"Hanoma";"2009SZ07Hanoma";"06.06.09";59;14;45;3;42;0,066666667
"1982";"Sal18";"Hleuco";"2009SZ08Hleuco";"06.06.09";66;19;47;1;46;0,021276596
"1983";"Sal2";"Hspira";"2009SZ09Hspira";"08.06.09";42;7;35;1;34;0,028571429
"1984";"Sal10";"Hpurpu";"2009SZ10Hpurpu";"08.06.09";94;7;87;4;83;0,045977011
"1985";"Sal9";"Hleuca";"2009SZ11Hleuca";"28.06.09";46;17;29;3;26;0,103448276
"1986";"Sal10";"Hpolit";"2009SZ12Hpolit";"29.06.09";8;0;8;0;8;0
"1987";"Sal9";"Hleuca";"2009SZ13Hleuca";"26.06.09";83;27;56;1;55;0,017857143
"1988";"Sal9";"Hpruss";"2009SZ14Hpruss";"27.06.09";63;25;38;0;38;0
"1989";"Sal31";"Hangli";"2009SZ15Hangli";"27.06.09";101;23;78;1;77;0,012820513
"1990";"Sal9";"Hpruss";"2009SZ16Hpruss";"28.06.09";58;13;45;4;41;0,088888889
"1991";"Sal9";"Hpruss";"2009SZ17Hpruss";"26.06.09";47;19;28;0;28;0
"1992";"Sal9";"Hpruss";"2009SZ18Hpruss";"29.06.09";54;11;43;1;42;0,023255814
"1993";"Sal31";"Hangli";"2009SZ19Hangli";"29.06.09";133;24;109;0;109;0
"1994";"Sal9";"Hleuca";"2009SZ20Hleuca";"27.06.09";164;67;97;6;91;0,06185567
"1995";"Sal9";"Hleuca";"2009SZ21Hleuca";"29.06.09";81;17;64;0;64;0
"1996";"Sal9";"Hpruss";"2009SZ22Hpruss";"12.07.09";69;38;31;0;31;0
"1997";"Sal9";"Hleuca";"2009SZ23Hleuca";"12.07.09";18;7;11;2;9;0,181818182
"1998";"Sal25";"Halien";"2009SZ24Halien";"12.07.09";67;42;25;4;21;0,16
"1999";"Sal25";"Heryth";"2009SZ25Heryth";"12.07.09";68;37;31;4;27;0,129032258
"2000";"Sal9";"Hpruss";"2009SZ28Hpruss";"27.08.09";67;29;38;0;38;0
"2001";"Sal9";"Hpruss";"2009SZ29Hpruss";"22.08.09";95;24;71;0;71;0
"2002";"Sal25";"Halien";"2009SZ30Halien";"26.08.09";38;27;11;0;11;0
"2003";"Sal25";"Heryth";"2009SZ31Heryth";"26.08.09";127;62;65;3;62;0,046153846
"2004";"Sal9";"Hleuca";"2010SZ01Hleuca";"20.06.10";69;34;35;2;33;0,057142857
"2005";"Sal9";"Hpruss";"2010SZ02Hpruss";"27.06.10";25;9;16;0;16;0
"2006";"Sal9";"Hpruss";"2010SZ03Hpruss";"25.06.10";30;14;16;3;13;0,1875
"2007";"Sal9";"Hleuca";"2010SZ04Hleuca";"25.06.10";49;31;18;6;12;0,333333333
"2008";"Sal9";"Hpruss";"2010SZ05Hpruss";"21.06.10";34;19;15;0;15;0
"2009";"Sal9";"Hleuca";"2010SZ06Hleuca";"25.06.10";72;49;23;0;23;0
"2010";"Sal31";"Hangli";"2010SZ07Hangli";"25.06.10";109;39;70;0;70;0
"2011";"Sal9";"Hleuca";"2010SZ08Hleuca";"27.06.10";21;11;10;1;9;0,1
"2012";"Sal31";"Hangli";"2010SZ09Hangli";"27.06.10";66;14;52;1;51;0,019230769
"2013";"Sal17";"Hplicg";"2010SZ20Hplicg";"05.08.10";14;6;8;1;7;0,125
"2014";"Sal17";"Hplicg";"2010SZ21Hplicg";"05.08.10";70;21;49;17;32;0,346938776
"2015";"Sal14";"Hacuti";"2010SZ22Hacuti";"05.08.10";23;7;16;3;13;0,1875
"2016";"Sal3";"Hischn";"2010SZ23Hischn";"04.08.10";73;31;42;1;41;0,023809524
"2017";"Sal14";"Hacuti";"2010SZ24Hacuti";"05.08.10";24;12;12;0;12;0
"2018";"Sal14";"Hplicl";"2010SZ25Hplicl";"07.08.10";212;76;136;6;130;0,044117647
"2019";"Sal14";"Hplicl";"2010SZ26Hplicl";"05.08.10";38;10;28;3;25;0,107142857
"2020";"Sal17";"Hplicg";"2010SZ27Hplicg";"04.08.10";101;26;75;37;38;0,493333333
"2021";"Sal17";"Hsglau";"2010SZ28Hsglau";"05.08.10";2;0;2;1;1;0,5
"2022";"Sal14";"Hplicl";"2010SZ29Hplicl";"05.08.10";17;1;16;3;13;0,1875
"2023";"Sal16";"Hnudip";"2010SZ30Hnudip";"07.08.10";124;21;103;13;90;0,126213592
"2024";"Sal17";"Hsglau";"2010SZ31Hsglau";"12.08.10";40;8;32;0;32;0
"2025";"Sal17";"Hsglau";"2010SZ32Hsglau";"07.08.10";45;17;28;4;24;0,142857143
"2026";"Sal17";"Hplicg";"2010SZ33Hplicg";"07.08.10";81;22;59;5;54;0,084745763
"2027";"Sal3";"Hischn";"2010SZ34Hischn";"07.08.10";19;7;12;0;12;0
"2028";"Sal17";"Hplicg";"2010SZ36Hplicg";"05.08.10";50;17;33;11;22;0,333333333
"2029";"Sal17";"Hplicg";"2010SZ37Hplicg";"11.08.10";62;34;28;1;27;0,035714286
"2030";"Sal27";"Hslana";"2010SZ38Hslana";"11.08.10";22;12;10;0;10;0
"2031";"Sal17";"Hplicg";"2010SZ39Hplicg";"12.08.10";51;15;36;7;29;0,194444444
"2032";"Sal14";"Hplicl";"2010SZ40Hplicl";"11.08.10";116;50;66;0;66;0
"2033";"Sal14";"Hplicl";"2010SZ41Hplicl";"15.08.10";54;3;51;11;40;0,215686275
"2034";"Sal14";"Hacuti";"2010SZ42Hacuti";"04.08.10";14;4;10;1;9;0,1
"2035";"Sal18";"Hleuco";"2010SZ43Hleuco";"07.08.10";16;6;10;0;10;0
"2036";"Sal16";"Hnudip";"2010SZ44Hnudip";"09.08.10";111;27;84;6;78;0,071428571
"2037";"Sal14";"Hplicl";"2010SZ45Hplicl";"12.08.10";82;34;48;1;47;0,020833333
"2038";"Sal3";"Hischn";"2010SZ46Hischn";"10.08.10";37;20;17;0;17;0
"2039";"Sal25";"Halien";"2010SZ47Halien";"12.08.10";29;16;13;0;13;0
"2040";"Sal17";"Hplicg";"2010SZ48Hplicg";"15.08.10";43;9;34;0;34;0
